мэйбилэнд: мэйбилэнде мэйбилэнд 
гол: голов 
раскрыться: раскрылся 
надеть: надето надет наденешь надену надев 
который: которых который которой которая которые котором которую которое 
её: её 
замкнуться: замкнулся 
слышать: слышишь слышу слышать слышал слышите 
ярлык: ярлыки 
классный: классный 
подумать: подумали подумал подумай подумать 
сделать: сделаешь сделаем сделал сделаю сделать 
фильтр: фильтр 
ка: ка 
клэп: клэпом 
официальный: официальное официальном официальный 
мяу: мяу 
утолить: утоли 
беброчко: беброчку 
тот: тех той ту тому та те 
дать: дала данная данной дайте дай дали дам дало данные даст дать дал 
обращаться: обращаясь 
монстр: монстры 
цвет: цвет цвета 
крд: крд 
карта: карте 
скушать: скушал 
мр: мр 
кухня: кухня 
удалять: удаляешь удаляю 
бельё: бельё белья 
океа: океа 
мнение: мнение мнению 
живой: живому живее живых 
осенний: осенний осенних 
шалавый: шалав 
лицо: лица лицом лицо лице 
мьюзик: мьюзик 
анна: анна 
клип: клип клипами клипе 
код: кодов код 
вспомнить: вспомнят вспомнить вспомню 
команда: команде 
разбиться: разобьюсь разбились разбилась 
общаться: общайся общаюсь общались общаться 
мыло: мыло 
чёлка: чёлкой 
проблема: проблем проблемах проблема проблему проблемы 
значить: значу 
свой: свой своим своему своё свои своём своих своей своем своего 
конец: конце конца конец 
против: против 
убежать: убежать убегу убежим 
внимание: внимания внимание 
налом: налом 
знать: знал знайте знает знаешь знают знать знай знала знали знаю знаете зная 
корень: корень 
целоваться: целуемся 
год: год годы лет года 
хва: хва 
пароль: пароль 
пара: пару парой пара парах 
пизда: пизда пизду пизды 
сиг: сиги сиг сига сигу 
личность: личности 
интенсив: интенсив 
грубый: грубый 
пуля: пули пуль 
секунда: секунды 
город: городом городам города городе город 
сложить: сложи 
нить: нена 
находиться: находятся находится находился 
спасать: спасать спасает спасают спасал 
гравитация: гравитацию 
светиться: свечусь 
сказать: скажешь скажи сказал сказали сказала сказать скажу 
уснуть: уснул уснёшь уснуть 
важный: важных важном важное 
отравлять: отравляют отравляешь 
кад: кадом 
ключик: ключик 
дизайн: дизайн 
постепенно: постепенно 
аз: аза аз 
вчера: вчера 
бейбить: бейби 
бэтмобиль: бэтмобиль 
падать: падала падает 
заколка: заколки 
потеряться: потерялся потеряюсь потеряемся потеряться потерялась 
съесть: съесть съедим съел съем 
хоч: хоч 
доставать: достает достаёт 
решка: решка 
событие: событий 
огромный: огромная огромный 
заменить: заменить заменит 
антивирусникнуть: антивирусник 
фитиль: фитиль 
согласиться: согласилась соглашусь согласится 
бой: бой 
ответ: ответ ответа 
кончить: кончить кончил 
зна: зна 
утро: утра утро утру 
бабка: бабки бабок 
мощь: мощь 
холодный: холодный холодным 
пробить: пробьёт 
зако: зако 
гря: гря 
ротик: ротик ротики 
москва: москва москву москве 
захотеть: захотела захотят захочешь 
слушатель: слушателя слушателям слушатели 
скруджа: скруджа 
долой: долой 
дрожать: дрожат 
миссис: миссис 
мартин: мартина мартин 
икарус: икарус 
глядеть: глядят 
глянуть: глянь 
перенести: перенести перенеси 
ида: иде ид 
ёбл: ёбл 
гореть: гори горят горит 
потухнуть: потухли потух 
поровну: поровну 
отсюда: отсюда 
учить: учу учить 
влюбиться: влюбиться влюбишься влюбится влюбилась влюбился 
узнаваемость: узнаваемости 
получиться: получилась получится 
спятить: спятил 
бесследно: бесследно 
злиться: злиться злишься злюсь злится 
достигнуть: достичь достиг 
рубль: рубли рублей рубль 
тор: тора 
ехать: ехать едем едет 
выставить: выставил 
каблук: каблук каблуков каблуки 
бесить: бесишь бесит 
обещание: обещания обещаний 
глотка: глотка глотку 
призрак: призрак 
уголёк: угольку 
согреть: согреешь согрею согреть 
показание: показаний 
интроверт: интроверт 
дерево: дерева дереве дерево 
март: марта марте 
птица: птицы 
повысить: повысили 
момент: момент моментам моменте моменты 
косячок: косячок 
туда: туда 
разъести: разъебём 
ночной: ночным 
поработать: поработать 
ёбаный: ебаные ёбаный ёбаная ёбаных ёбаные 
тапка: тапки 
валюнина: валюнин 
сам: сами самом самого само самой сама 
кидать: кидаю кидаешь 
бояться: бойся боишься боялся боюсь 
канал: канале каналах канал 
подышать: подышу подышать 
вселенная: вселенных 
лайтереть: лайтер 
сломать: сломан сломали сломаем 
гулять: гуляем гулять гуляла 
погаснуть: погас 
поверь: поверь 
сука: суку сук суке сука суки сукой 
стена: стенам стену стены стенах стена 
въебиться: въебёмся 
точилка: точилка 
кей: кей 
колесо: колесо колёс 
безудержный: безудержная 
идеально: идеально 
дом: доме домов дом домом дома 
смазливый: смазливый 
рассказывать: рассказывающая рассказывающий рассказывал рассказывает 
бар: бара 
точно: точно 
сотый: сотый 
добро: добро 
угодить: угодить 
слеза: слезы слеза слёз слёзы слезах 
целовать: целуешь целует 
встреча: встречи встреча встречу 
число: числа число числе 
золотистый: золотистый 
положить: положу 
вдых: вдыха 
закрой: закрою 
дропнуть: дропнем дропнул 
плохо: плохо 
замок: замке замок 
пойти: пойти пошёл пойду пойди пойдёт пойдешь пойдём пошла 
доска: доска 
пожелать: пожелать 
платить: платит 
недоверие: недоверие 
синкай: синкая 
порядок: порядок 
заглушить: заглушат заглушит заглушить 
продолжение: продолжение 
деятельность: деятельности 
голос: голос голоса голосом голосов 
портал: портал 
пинк: пинк 
залить: залью залили 
голова: голову головы головою голове головой головах голова 
верх: верх 
приехать: приедешь приехать приедет 
случай: случае 
реальный: реальном реальный 
пэйн: пэйн 
поколение: поколений поколениям 
антифриз: антифриз 
насколько: насколько 
давать: даешь давай даёшь давали даю даёт 
пф: пф 
красивый: красивая красива красивым 
ксива: ксиву ксива 
вроде: вроде 
душнить: душнить 
лестница: лестница 
выйти: вышел вышла вышло вышли выйти выйдет 
отпустить: отпустит отпущу 
редкий: редкая редкий 
смывать: смываю 
мировой: мировые мировом 
окно: окно окном окна окнами 
вести: ведёт ведёшь веду 
выложить: выложил выложен 
старый: старые старый старой 
день: днём дни дне дня день 
стоять: стоят 
полоса: полоса полосы 
привыкнуть: привыкла 
молли: молли 
я: мною мной 
кинуть: кинули кинул 
сделка: сделку 
дорогой: дороже дорогие дорогая 
упоминание: упоминание 
бонг: бонга 
одноклассник: одноклассники 
рассуждать: рассуждает рассуждаешь 
слезть: слезть 
сентябрь: сентябре сентября 
состояться: состоялся 
кайфовеять: кайфовей 
фон: фоне фона 
обижать: обижают обижала 
лиза: лиза 
возможно: возможно 
скучно: скучно 
девочка: девочка девочки 
разный: разным разные разных 
прослушивание: прослушивания 
стик: стике 
интро: интро 
хайпертрэп: хайпертрэп 
трепет: трепет 
обещать: обещаю обещать обещал обещай 
разбитый: разбитым разбитый разбит 
выполнить: выполнен 
страх: страхе страх 
кончиться: кончились кончилась 
мерседес: мерседесе 
леч: леч 
пиздатый: пиздатый 
вечером: вечером 
собирать: собираю собирай 
планета: планеты планете планету 
воу: воу 
присутствовать: присутствует 
выкладывать: выкладывал 
чу: чу 
стрелка: стрелка стрелки 
мы: нами нам 
папа: пап папа папой 
высокий: высокий высшая 
прикоснуться: прикоснуться 
обложка: обложка обложкой обложки обложек обложку обложке 
белый: белая белое белым белую белее белой белый 
диск: диски 
весна: весны весна 
виноватый: виновата виноваты виноват 
каждый: каждая каждым каждый каждого каждом каждую 
олицетворение: олицетворение 
понимать: понимает понимаешь понимал понимать понимаю 
большой: большом большой 
чудо: чуда чудес чудеса 
облом: облом 
парень: парня парнем парень 
постприпев: постприпев 
застылый: застыла 
рот: рта рот рту 
такой: таком такие таким такая такую такое такого таких 
сжигать: сжигает 
взять: взята взят возьми возьму возьмет взять взял взяла 
зайти: зашла зашёл зашел 
кроссик: кроссики 
грызть: грызёт 
газовый: газовым 
чей: чьё 
тусить: тусить 
достижение: достижений 
неполадка: неполадки 
часть: часть части 
прочитать: прочитанная 
верить: верил веришь верить верят верю верь 
улетать: улетают 
беларусь: беларусь 
гораздо: гораздо 
газманов: газманова 
грудь: груди 
привлечь: привлечь 
чернышёв: чернышев 
параметр: параметры 
игнора: игноре 
дед: дед 
поздний: позже попозже 
соизмеримый: соизмеримо 
разбудить: разбудить разбуди 
шасси: шасси 
сперма: сперма 
главное: главное 
завернуть: заверну 
верхом: верхом 
синяк: синяками 
уходить: уходи ухожу 
расправить: расправь 
неожиданный: неожиданные неожиданным 
парта: парт 
вкус: вкусом 
выступление: выступлении выступление 
вряд: вряд 
знакомиться: знакомься 
розетка: розетка 
старт: старт старта 
трое: трое 
ебать: ебать 
ноль: ноль 
хуйня: хуйнёй хуйню хуйне 
полный: полон полна полной полный 
отключка: отключке 
остановиться: остановись 
пороть: поря 
ус: усы 
гласс: гласс 
сорт: сорта 
создание: создании создания 
лям: ляма лямов 
учитывать: учитывая 
башка: башке башка башку башкой 
хи: хи 
пузатый: пузата 
гадать: гадать 
улыбка: улыбка 
ос: ос 
цок: цок 
лупить: лупит 
план: планы 
проснуться: проснёшься проснулся проснёмся проснуться проснусь 
осознание: осознание 
тьма: тьме 
ад: ад 
клуб: клуб клубе 
залечить: залечить 
рука: рукой рук руки руками руке рука руках руку 
он: нему нём 
синий: синяя синий синие 
бокал: бокалом бокале бокал 
купюра: купюр 
сдаться: сдамся 
сниппеть: сниппет сниппетом сниппета 
сто: сто 
офис: офис 
пазл: пазлы пазл 
перекручивать: перекручивает 
блестеть: блестят 
дерьмо: дерьмо дерьмом 
сбредить: сбредить 
волновать: волновать волнуют волнует 
тоненький: тоненькими 
щеколда: щеколда 
камил: камилов 
разом: разом 
обрезать: обрезаешь 
грязный: грязном грязная 
помада: помадой 
аутро: аутро 
странный: странных странные странным странный 
маленький: маленький меньше 
ечь: ечь 
вдох: вдох 
искать: ищешь искал искала ищет ищу ищи искать 
быстрый: быстрее быстрей побыстрее 
сингл: сингла сингле синглом синглу сингл 
очнуться: очнусь 
розовый: розовые розовый розовой 
место: местами место места местам мест месте местах 
дипси: дипси 
беда: беда бед 
признаться: признаюсь 
тихо: тихо 
спать: спишь спят спать сплю спи 
подруга: подругой подруги подруге подруга 
мешать: мешаю 
басс: басс 
женский: женской 
около: около 
нога: ногах ног ноги 
гора: горе горой 
засыпать: засыпаешь засыпай засыпает засыпать засыпаю 
закончить: закончена закончил закончу закончишь 
звонить: звонить звонил звоню звонишь звони 
показывать: показывает показывали 
объявление: объявление 
бандаж: бандаж 
радость: радостью радость 
прощение: прощения 
потерять: потеряла потеряли потерять потеряю потерял 
вид: виде вид 
представить: представил представила представлен представить 
дурить: дурит 
составлять: составляющая 
школа: школа школы школе 
буд: буда буды 
навечно: навечно 
шикарный: шикарен шикарная 
тара: тар 
вероника: вероника веронике 
катить: катит 
десятый: десятый 
режиссёр: режиссёра 
метроном: метроном 
рыжий: рыжая 
остыть: остынь остынешь 
формат: формате 
найти: нашла нашёл найди найдут нашел найдёт найдёшь найти найду 
шампунь: шампуня 
тюмень: тюмень 
мальчик: мальчик мальчики 
заливать: заливаю заливать 
похожий: похожи похожий похож 
мать: мать матери 
лейбл: лейблы лейбла 
забрать: заберёшь забрать заберу забрала забрал заберём забери 
эго: эго 
чи: чи 
просто: просто 
занести: занёс 
опубликовать: опубликован опубликовали опубликовал 
литр: литра 
приходить: приходи 
помнить: помнишь помнит помню помнить 
адренохром: адренохром 
гнать: гонят 
раздел: разделу 
закрыть: закрыть закрыл закрыв закрой 
потратить: потрачу 
группа: группы группой группа группе 
скрыть: скроет 
перевыпускаться: перевыпускался 
киса: киса кисе кис 
социофоб: социофобы 
напоминать: напоминает 
зря: зря 
мама: мамой маме мама мам мамы 
использоваться: использовался 
хмуриться: хмуришься 
тво: тво 
ситтереть: ситтер 
грустный: грустные грустное грустная 
снайпер: снайпер 
нравиться: нравятся нравится нравился 
продвигать: продвигайте 
значит: значит 
разбросать: разбросаны 
чарт: чарте чарты чарт 
тупой: тупым тупая 
апатия: апатии апатия 
ая: ае аю 
ет: ет 
испугать: испугать 
защищать: защищает 
наркота: наркота наркоты 
тип: типа типу типов 
флешка: флешку 
мост: мосты мосту 
создать: создал создать 
лав: лав 
будущий: будущему 
зомби: зомби 
сводить: свожу 
поезд: поезд поезда 
стоп: стоп 
отношение: отношениях отношения отношений 
странно: странно 
ожидание: ожидании ожиданием 
мечтать: мечтать мечтаю 
богатый: богатым богатый 
взаправду: взаправду 
дырка: дырка дырку 
слава: слава славе 
звучание: звучание 
кино: кино 
видеть: видел видите видела видишь видит вижу видеть 
этап: этап 
кропать: кропали 
пожар: пожар 
одеяло: одеяло одеялом 
наполнить: наполню наполнить 
пидор: пидор 
суть: сути 
третий: третий 
следить: следят 
мочь: можешь могла могли мог могут могу можем 
денёк: деньки 
витать: витаю 
истерик: истерик 
аф: аф 
вебок: вебкам 
тикток: тиктока тикток тиктоке 
музыкант: музыканту музыкант 
уйти: уйти ушёл уйду уйдешь уйди 
вокальный: вокальная 
социальный: социальный социальных 
отражение: отражение 
жарко: жарко 
это: этим это 
нужный: нужен нужна нужны 
скамятый: скамят 
себя: собою собой 
рить: рили 
щ: щ 
поздно: поздно поздна 
медвежий: медвежья 
респект: респекта 
потрогать: потрогать 
бутылка: бутылки 
книга: книга 
договориться: договорится 
товарищ: товарищу 
сменить: сменит 
связь: связь связи 
наркотик: наркотики наркотик наркотиков 
толчок: толчок 
кожа: кожа кожи коже 
редко: редко 
купить: купить купит купишь купил купим купи куплю 
серьёзно: серьёзно 
выпивать: выпиваю выпиваешь 
капля: капли 
ишь: ишь 
дождь: дождь дождях 
хотеться: хочется хотелось 
присутствие: присутствие 
рабочий: рабочей 
версия: версию версия версией 
власть: власти 
пол: полу пола полам пол 
придурок: придурок 
шаг: шагами шаг 
уборная: уборной 
ванная: ванной 
предать: предав 
дуэль: дуэль 
окошко: окошко 
попробовать: попробую попробуй 
жаль: жаль 
чужой: чужие чужих чужими чужой 
цена: цену цена 
доказать: докажи 
рай: рай 
надежда: надежде надежда надежды 
мно: мно 
ток: тока ток 
исполнитель: исполнитель исполнителя 
собрать: собрал собери собрать 
электричество: электричества 
услышать: услышите услышать услышал услышан услышишь 
раздеться: разделась 
свеча: свечи 
ты: тобою тобой тебе 
нюхать: нюхать нюхаю нюхал 
сюда: сюда 
тепло: тепла тепло 
прятать: прятать прячу прячешь прячет 
кусок: куски кусок 
долгий: дольше 
подарить: подарить подарил подарю 
новгород: новгорода 
снимать: снимает снимай 
вонять: воняют 
юбчонка: юбчонка 
талант: талантами талант 
парить: парят парю 
рамный: рамен 
спектакль: спектакль 
аудитория: аудитории аудиторией 
бреда: бреду 
саундклаудовский: саундклаудовскую 
молекула: молекулы 
заводить: завожу 
своровать: своровал 
сюрприз: сюрприз 
банча: банчу 
данил: данила 
первый: первая первую первое первых первого первой первым первый первые первом 
легендарный: легендарное 
дисса: дисс 
икать: икает икать 
кто: кем кому 
логин: логин 
мигом: мигом 
платёж: платежи 
тошный: тошно 
вальс: вальс 
релиз: релиза релиз релизы 
блин: блин 
человек: людей людьми люди человек человеком 
волк: волк 
шмотки: шмотки шмотках 
обнять: обнять 
шипучка: шипучка 
возможность: возможность 
ве: ве 
чувство: чувствах чувств чувство чувства 
длиться: длится 
губа: губах губ губы губами губам 
просить: просила просить просят просит прошу 
смысл: смысле смысла смыслом смысл 
быть: буду будут будь суть будешь е будем 
беспокоить: беспокоит 
поиск: поиске 
алый: алые 
сила: силу силой силы сил 
девчонка: девчонку девчонками девчонки 
похуй: похуй 
коля: коля 
плыть: плывёт плыть плыву 
обидно: обидно 
вместе: вместе 
бизнес: бизнес 
погасить: погашу 
право: права 
оберегать: оберегает 
обитать: обитаю обитают 
отпускать: отпускать 
всякий: всякой всякое 
больший: большая большим 
вспоминать: вспоминаю вспоминай вспоминает 
вырвать: вырву 
музона: музон 
дебаты: дебаты 
макать: макаю 
поебать: поебать 
выбирать: выбирает 
спрашивать: спрашивал 
подкуриться: подкурюсь 
най: най 
устоева: устоева 
некрасиво: некрасиво 
рядом: рядом 
самый: самый самая самые самую самое самых самым 
миксер: миксер 
тормоз: тормоза 
ленинградский: ленинградского 
мозг: мозги мозг мозгам 
манташов: манташов 
дата: датой дату 
замёрзнуть: замёрзнуть замёрзли 
поставить: поставь поставить 
посвятить: посвящён посвящено посвящённый 
заставить: заставит заставил 
прошмоукать: прошмоукал 
убедить: убедить 
работать: работай работает работал 
внимательный: повнимательней 
раскачать: раскачаю 
трус: трусах трусы 
мертворождённый: мертворождённой 
спустя: спустя 
агха: агх 
зяббаров: зяббаров 
завтра: завтра 
оружие: оружием оружие 
пытаться: пытался пыталась пытайся пытаясь пытаюсь 
готовить: готовлю готовит 
вызывать: вызываешь вызывай 
другой: другая другому другие другого другим другое другую 
конфликт: конфликта 
подружка: подружку подружек 
упомянуть: упомянул 
спальня: спальню спальня спальне 
провод: проводе провода провод 
фильм: фильма 
убить: убило убьёт убить убила убью убей убил 
совместный: совместной совместное совместная совместного 
свести: свёл 
впереди: впереди 
наступить: наступит наступят 
заполучить: заполучил 
путь: пути путь 
кроваво: кроваво 
газировка: газировки 
пас: пас 
рёт: рёта 
глаз: глазах глазам глаз глаза глазами 
дым: дым дыма дыму 
хайперскок: хайперскок 
сообщить: сообщил 
история: история историю истории 
написать: написать напиши напишешь напишу 
питать: питаешь питает 
хардкор: хардкор 
зай: зай 
котёнок: котёнка 
настоящий: настоящий настоящем 
загон: загонов 
истратить: истрачена 
пиксель: пикселя 
артист: артистам артистами артистов артисты артист артиста 
успеть: успели успела успел 
помочь: поможешь помоги поможет 
крик: крики крик 
перехватить: перехватить 
стараться: старался стараюсь 
лезвие: лезвием лезвие 
жизнь: жизнь жизни 
дышать: дышим дышишь 
сердечко: сердечках сердечки сердечко 
село: села 
стрёмный: стрёмное стрёмная 
вдуть: вдуй 
сейчас: щас ща 
плацкарта: плацкарт 
выраженный: выраженные 
подождать: подожди подожду 
первокурсница: первокурсница 
возникнуть: возникли 
скрываться: скрываться скрываюсь 
балкон: балконы балконе 
тянуть: тянет тяну 
перекрыть: перекрыв 
незадолго: незадолго 
ориентация: ориентацию 
текила: текилы 
пнуть: пнуть 
лёд: льда льдом лед лёд 
хоть: холо 
сниться: снится снился 
дпс: дпс 
сбыться: сбылась сбудется сбылись 
свободный: свободен 
линия: линию 
созвездие: созвездия 
оставить: оставь оставлю оставит оставишь оставить оставил 
блок: блок 
союз: союз 
прийти: пришла пришло приди 
повествовать: повествует 
облако: облакам облако облака облаках 
текстовка: текстовка 
платформа: платформе платформы 
обувь: обувь 
час: часов час 
уют: уют 
понарошку: понарошку 
твой: твоё твоим твоей твое твоих твой твоём твою твоего твоя твои 
ребёнок: дети детей ребёнка ребёнок 
говорить: говори говорить говорила говорят говоришь говорили говорил говорит говорим 
бредить: бредишь 
ореол: ореол 
тлеть: тлеет тлею 
опыт: опыте 
сопровождаться: сопровождался 
принимать: принимает 
вено: веном венах 
нуль: нули нуля 
спортсмен: спортсмен 
трэп: трэп 
сигнал: сигналы 
юзать: юзай юзаю 
экран: экран экранах 
люберцы: люберцах 
хо: хо 
отель: отель 
служить: служат 
мэри: мэри 
бука: бука 
белые: белые 
пешка: пешка 
эхо: эхо 
сладко: сладко 
хэй: хэй 
пш: пш 
прийтись: придётся придется пришлось 
грязно: грязно 
изначально: изначально 
даша: даша 
бухой: бухой бухие 
тяжёлый: тяжелой тяжёлый 
август: августа 
суббота: субботу 
вена: вены 
телепорт: телепорт 
земля: земле земли земля 
кризис: кризис 
придумать: придумал придумает 
провал: провала 
наколдовать: наколдовала 
далёкий: дальше подальше далека 
разбивать: разбиваю 
один: одной одна одном одну одного одни 
убивать: убивают убиваю убивает 
устать: устали устал 
извинить: извини 
лето: лета летом лето 
терять: теряю теряем терять 
маг: маг 
весь: всей весь всему вся всем 
фэйк: фэйк 
догнать: догнать догонит 
плюнуть: плюнул 
намёк: намёки намеком 
фа: фа 
мелодичный: мелодичных 
андрей: андрей 
эксперимент: эксперименты 
гениальность: гениальность 
абонент: абонент 
рост: роста 
должный: должна должен должны 
пиздить: пиздишь пиздят пиздить 
ходить: хожу ходят 
сосать: соси сосёт 
кабак: кабакам 
открыть: открыт открыл открыла открыть открой 
крутить: крутят крути 
обнимания: обниманий 
пушкарёв: пушкарев 
подъезд: подъезды 
кровавый: кровавой 
несерьёзный: несерьёзным 
мысленный: мысленное 
вечность: вечность 
площадка: площадках площадке площадки 
ангел: ангел 
мир: мире мира мир мирами 
фанатка: фанатка 
звезда: звёзды звёздам звёзд звезда 
участник: участников 
вирус: вирус вирусом вируса 
улететь: улетели улетела улечу улетим 
выше: выше 
приветствовать: приветствует 
образ: образе образ 
зависать: зависаю зависай 
охват: охват 
лежать: лежит лежу 
привыкать: привыкаю 
губка: губки 
скилла: скилл 
булка: булки 
тизер: тизер тизере 
альбом: альбоме альбому альбома альбом 
дописать: дописать допишу 
ёт: ёт 
убрать: убери 
подделать: подделать 
часы: часах часы 
травма: травмы травма 
запомнить: запомню запомни запомнил запомнить 
крыса: крысы крысой крыс 
разлетаться: разлетается разлетаться 
перебить: перебили 
стрелять: стреляю 
плод: плод 
убегать: убегают убегаю 
покупать: покупают 
искренность: искренность 
дельтаплан: дельтапланы 
ален: алена 
трап: трапе трап 
врезаться: врезался 
ск: скам 
возле: возле 
слюни: слюни слюнях слюнями слюней 
зализать: залижешь 
музыка: музыку музыка музыке 
подарок: подарок подарком подарки 
помогать: помогают помогать помогает 
казаться: казалось кажется казалась 
впервые: впервые 
иск: иска 
сойти: сошёл сойду сойдём 
пузо: пузо 
муравей: муравьи 
уровень: уровне 
поднять: поднять поднял поднимешь подниму 
ноготь: ногти 
виртуальный: виртуальный виртуальные 
наебать: наебать 
мутный: мутные 
зелень: зелень 
киска: киску киска 
русский: русских русский русское 
лететь: летит лечу летим летел 
бегать: бегал 
деньга: деньги денег 
песня: песен песней песне песня песни песню 
лё: лё 
враг: врага 
эй: эй 
тонуть: тонущий тонут тонущего тонешь 
планетарий: планетарий 
вообще: вообще 
красный: красный красные красно красное красных красная 
знакомый: знакомый знакомо знакомы 
подносить: подношу 
закрыться: закроемся 
льзить: льзя 
присылать: присылает 
мо: мо 
ужалить: ужалил 
фигура: фигура 
член: член 
вперемешку: вперемешку 
откачать: откачай 
старание: старанья 
гарем: гарем 
народ: народа 
внутри: внутри 
переставать: перестают 
замерзать: замерзаю 
буэ: буэ 
унести: унесло 
концерт: концерт концерте 
такси: такси 
юрист: юристы 
навсегда: навсегда 
позвонить: позвони позвонить 
туман: туман 
древний: древние 
ё: ё 
кричать: кричат кричишь кричу кричал кричать 
осень: осени осень 
положительный: положительным 
цепить: цепя 
шея: шее шею шеи 
фэйм: фэйма 
жи: жи 
заметить: заметила заметил замечен заметит 
элджей: элджей 
поляк: поляков 
псих: психи 
вчерашний: вчерашний 
стандартный: стандартный 
пропасть: пропали пропал пропастью пропаду пропасть 
фью: фью 
рэпер: рэпер рэперов 
бросить: бросил бросит брошу 
свэг: свэг свэга 
рубин: рубин 
намекать: намекать 
двашка: двашки 
облизать: оближу облизать 
удача: удачи 
надолго: надолго 
вдохновить: вдохновлённый вдохновлена вдохновит 
панча: панчи 
боль: боль боли 
единица: единица 
итог: итоге 
поговорить: поговорить 
ждать: ждём ждать ждёшь ждёт ждут жду жди 
выкинуть: выкинул 
некоронованный: некоронованный 
октябрь: октябре октября октябрь 
заполнить: заполнил 
поиграть: поиграем 
лида: лида лиды 
рассказать: рассказать рассказал расскажу 
остаться: остался останься остались останутся осталась остаться останешься осталось останусь 
блёсс: блессе 
дротик: дротики 
мороз: мороз мороза 
сейч: сейча 
съебаться: съебался 
что: чё чему чём 
мёртвый: мёртвый мёртв 
золото: золота 
иметь: иметь 
ёбнутаить: ёбнутая 
завтрак: завтрак 
штаны: штанов штаны штанах 
думать: думал думай думаешь думаю думает думала думать 
бритни: бритни 
сушить: сушит 
запоминать: запоминать 
красить: красит 
зима: зима зиму 
сплиф: сплиф 
приятно: приятно 
школьный: школьном школьное 
бежать: бежим бежать беги бежит 
луч: луч 
течь: текут течёт 
доделаться: доделается 
новый: новой новые нового новую новыми новый 
отменить: отменили отменить 
медленно: медленно 
повсюду: повсюду 
грустно: грустно 
кузнецов: кузнецов 
мобила: мобила 
идти: иди иду идёт шел идти идёшь идём 
имя: имена имя 
вещь: вещи 
фэс: фэс 
поменять: поменять поменяло 
мечта: мечте мечты мечтами мечта 
заявлять: заявляет 
гром: гром 
э: э 
отвечать: отвечаешь 
сомнение: сомнения 
залипнуть: залипнуть 
двадцать: двадцать 
снова: снова 
записать: записал записали записанный 
ставка: ставки 
спрятать: спрячу спрятаны спрячешь 
косаева: косаева 
счёт: счету 
расщепить: расщепило 
наливать: наливают наливаю наливает 
уметь: умеет умею 
тёлка: тёлка телки тёлки 
наркотэ: наркотэ 
пацан: пацан пацаны пацанах 
интересно: интересно 
перегаснуть: перегаснет 
расстройство: расстройств 
девушка: девушкой девушками девушка девушки девушке 
уэй: уэй 
пережить: пережитой 
дважды: дважды 
блевать: блюй 
полумягкий: полумягкий 
никто: никто никого 
фе: фе 
йо: йо 
тузик: тузик 
вахтер: вахтерам 
интересный: интересны интересней 
оля: оль 
орех: орех 
мишка: мишка 
гу: гу 
задеть: задеть задето 
ложиться: ложусь ложись 
правило: правила 
пропадать: пропадают 
малыш: малыш 
бондарев: бондарев 
билет: билета 
войти: войдёт 
шестьдесят: шестьдесят 
дмитрий: дмитрий 
рождение: рождения 
телефон: телефон телефоне телефоны телефона 
оптом: оптом 
огонь: огне огни огонь огнём 
современный: современных 
проса: прос 
сцена: сцену сцены сцене 
додикий: додики 
утолять: утоляет 
фак: фак 
хуёво: хуёво 
несчастие: несчастье 
общий: общей общем 
зелёный: зелёный зелёные 
ру: ру 
соцсеть: соцсетях соцсети 
эфирный: эфирным 
татарский: татарский 
вскрывать: вскрываю 
пустить: пустите пустить 
вывести: вывел 
закатиться: закатятся 
хей: хей 
насувал: насувал 
торчать: торчит торчу торчи 
сайфер: сайфер 
шпагат: шпагат 
бойфренд: бойфренд 
вильчинский: вильчинский 
бортик: бортиков 
поджигать: поджигаю 
близкий: поближе ближе ближайшее 
лить: лью льёт 
выпасть: выпала 
воспоминание: воспоминания 
бабочка: бабочки 
вечер: вечер вечера 
исчезать: исчезай исчезаю исчезает 
тошнить: тошнит 
засолить: засолить 
вино: вина 
ахуеть: ахуеть 
исчезнуть: исчезну исчез 
нижний: нижнего 
хуй: хуй хуями 
лечь: лягу легла 
ветер: ветер ветру 
пора: пора пор 
севентина: севентина 
гаснуть: гаснут гаснет 
всерьёз: всерьёз 
использовать: используя использует использовать 
мидорим: мидорима 
нормальный: нормальным 
выход: выхода выходом выходе выход 
попить: попил попить 
родитель: родителям 
увезти: увёз 
бывать: бывает бываю 
умножить: умножить 
натс: натс 
ранний: раньше 
прикреплять: прикрепляю 
утащить: утащу 
дебютный: дебютном 
сесть: сесть сядем 
темнота: темнотой темнота темноту темноте 
бомба: бомба 
беззвучный: беззвучном 
ценник: ценник 
ху: ху 
фита: фит 
ларан: ларан 
коктейль: коктейль 
прощать: прощай прощаю 
микрофон: микрофон 
услуга: услуга 
машина: машина машину машине 
любовь: любви любовь 
мясо: мясо 
наложение: наложения 
ом: ом 
лыжа: лыжи 
сожаление: сожалению 
сума: сум 
схожесть: схожесть 
патрон: патроны 
сергей: сергей 
турить: турю 
тетрадь: тетрадь 
бебра: бебра бебр бебру 
тра: тра 
записка: записку 
покорять: покорять 
маник: маник 
настоебать: настоебали 
пожаловать: пожаловать 
трип: трип 
влететь: влечу 
альтернативный: альтернативный альтернативная альтернативные 
пепельница: пепельница 
данный: данного данную данный данном 
скорость: скорость скоростях скорости 
пик: пик 
ходаки: ходаки 
северный: северное 
орбита: орбита 
пепел: пепел пеплом 
оверсайза: оверсайз 
несмотря: несмотря 
гнида: гнида 
российский: российских 
собираться: собирался 
модель: модели модель 
уверенный: уверен 
банк: банке банк банком банка 
подушка: подушек подушку 
склеить: склеит 
тусовка: тусовке тусовках 
хотеть: хотели хочешь хочет хотел хотят хотела хочу 
равно: равно 
стакан: стакан 
кровать: кроватью кровати кровать 
молодой: молодой молодая молоды молод молодого молодых 
отключать: отключаешь 
палить: палят палю палит 
река: реки река 
хвататета: хвататет 
доступный: доступен 
незачем: незачем 
комната: комнате комнату 
тело: тела теле тело телом 
трафик: трафик 
ролекс: ролекс 
наломать: наломал 
милый: милые милый милой 
оставаться: остаюсь остаётся оставаться 
текст: тексте текст 
отрава: отравы отраву 
протестант: протестант 
какой: какого каком какие 
к: ко 
микро: микро 
контакт: контакт 
хата: хату хате хата 
красться: крадусь 
наглеть: наглеешь 
рэп: рэпа рэп 
недосказанность: недосказанности 
рок: рок 
сми: сми 
понять: пойми поняли пойму понял поймут понять 
довольный: довольна 
алий: алия 
твёркай: твёркаю 
одежда: одежда одежду 
разгадать: разгадала 
наш: наших нашим наш нашего нашу наша наши 
пиздеть: пиздеть 
онгоинга: онгоинг 
далеко: далеко 
запретный: запретный 
играть: играем играют играю играет играть играл 
дело: дело дел дела деле 
причинять: причиняешь 
жажда: жажду 
анонсироваться: анонсировалась 
вернуть: вернёшь верни верну вернуть 
выбросить: выбросил 
лох: лох 
тёмный: тёмная тёмными тёмной 
малышка: малышка 
окурочки: окурочков 
пригласить: приглашённая 
ого: ого 
ожидать: ожидает ожидаю 
кровь: кровью кровь крови 
хуесоса: хуесосах 
позвать: позвал позвала 
взрывной: взрывной 
размер: размер 
спускаться: спускайся 
спичка: спичка 
игрушка: игрушки игрушка игрушек 
нуждаться: нуждался 
взрослый: взрослым взрослой взрослый 
кукла: кукла 
приведение: приведение 
зайка: зайка 
посильный: посильнее 
тишка: тишка тишку 
легенда: легенда 
растерять: растерян 
относиться: относился 
задувать: задувает 
крыло: крылья крыльев 
комп: компа 
истина: истиной 
медник: медников 
высоко: высоко повыше 
брат: братьев брата 
любимый: любимые любимых любимое 
тратить: трать 
качели: качели 
потрепать: потрёпанных 
занятой: занятой 
художник: художник 
эффект: эффект 
пусто: пусто 
принять: приняла принять прими 
пачка: пачки пачку 
воскресать: воскресаю 
решение: решение 
луна: луной луны луна луну луне 
прыгать: прыгаем прыгаю прыгает прыгай 
душить: душат душит 
сволочь: сволочь 
ольга: ольга 
яркий: ярче яркий 
попасть: попал попасть 
зелье: зелье 
пудра: пудра 
абьюзивный: абьюзивные 
забирать: забирает забирай 
ничтожество: ничтожество 
перестать: перестань перестала перестал 
естественный: естественному 
гиперпоп: гиперпоп 
утечка: утечке 
умереть: умру умерла умер умрут 
расстаться: расстаться расстанемся 
ниже: ниже 
глава: глава 
временно: временно 
смотреть: смотрит смотреть смотрят смотрю смотри 
иван: иван 
джоинт: джоинт 
соль: солях 
никита: никита 
припев: припев 
тат: тату 
безнадёжный: безнадёжен 
овечка: овечка 
подохнуть: подохла подохнет 
хлой: хлоя 
погубить: погубит 
долбаный: долбаном 
кружок: кружок 
снежинка: снежинки снежинках 
ку: ку 
осознать: осознай осознать 
трек: треком треки треке треку трек трека 
подзаряд: подзаряде подзаряд 
чёрный: чёрный черный чёрная чёрные 
бренд: бренд 
минута: минут минуту минута 
ночью: ночью 
гитара: гитары 
инструментал: инструменталы 
тупо: тупо 
дроп: дроп 
мах: мах 
стаканчик: стаканчик 
пау: пау 
стан: стан 
сзади: сзади 
ебучаять: ебучая 
подсказать: подскажет 
нюх: нюх 
луноход: луноходы 
поднимать: поднимаю 
укурок: укурок 
доктор: доктор доктору 
тройка: тройка 
имидж: имиджа 
назвать: назвала назвал 
жожо: жожо 
позлить: позлить 
закинуть: закинул закину 
месяц: месяца месяц 
магнит: магниту 
приказ: приказы 
хитовый: хитово 
наркоть: наркоти 
память: памяти память 
палец: пальцы палец 
нерв: нервы 
продать: продал 
неверленд: неверленд 
пресс: пресс 
катакан: катакану 
метко: метко 
ы: ы 
математика: математике 
крепкий: крепче 
скучать: скучаю 
сортир: сортире 
друг: другом друг другу друзей друзья друга друзьями 
вставка: вставок 
паспортный: паспортные 
выучить: выучил 
строчка: строчка 
словно: словно 
больной: больное больней больнее 
вопрос: вопросы вопросов 
двусторонний: двустороннее 
комета: кометы 
остановить: остановить 
ляпка: ляпки 
итого: итого 
упасть: упасть упало упала упав 
тур: тур тура 
удивить: удиви 
кот: кот кота 
расти: рос 
поплавский: поплавский 
лоб: лоб 
достать: достала достанет достать 
страница: странице 
заставлять: заставляет 
ксэнни: ксэнни 
одиноко: одиноко 
накрыть: накроет 
зажечь: зажгли 
магазин: магазин магазине 
переосмысление: переосмысление 
дверь: дверях дверь 
трамадол: трамадола 
псиблейда: псиблейда псиблейды 
букет: букет 
нужно: нужно 
семнадцатый: семнадцатый 
заполнять: заполняет 
спа: спа 
ножка: ножек 
слово: словами слово словом словам слов слова 
соскучиться: соскучился 
арсений: арсений 
писать: писал пишешь пишем пишет пиши пишут 
никакой: никакой никаких 
напиздеть: напиздел 
топ: топ 
бабаевский: бабаевский 
отвязаться: отвязался 
накурить: накурен 
напрягаться: напрягайся 
полежать: полежать 
инвалид: инвалидов 
вживую: вживую 
май: май мая 
отец: отцом отцу отец 
улыбаться: улыбаешься улыбается улыбаться улыбаюсь 
придача: придачу 
мила: мила 
зло: зол 
снять: снять снял сняла сними 
скидывать: скидываю 
бумага: бумаги бумага 
дама: дамы 
шинтаро: шинтаро 
медведица: медведица 
вовсе: вовсе 
пыль: пыль 
пиздато: пиздато 
оказывать: оказывая 
гладить: глажу 
зуб: зубах зубы зуб 
мой: моём моих моей мои моим моем моему мое моё моими мою 
чистый: чистый чистом чистая 
покраснеть: покраснел 
уй: уй 
шина: шина 
заиграться: заиграться 
кола: колы колой коле 
ахуй: ахуе 
лгать: лгать 
синдром: синдром 
главный: главный главной главными 
вдали: вдали 
дистрибьютор: дистрибьюторов 
вс: вс 
полюбить: полюбил полюбила полюбить 
посещать: посещает посещай 
имп: имп 
отнести: отнесу 
поддерживать: поддерживал 
включать: включай 
рисковать: рискую рисковать 
ваня: ваней вани 
кубик: кубики 
куча: куча 
касторский: касторский 
ебанный: ебанный 
подойти: подойди подойдут 
крыша: крыши крышу 
медленный: медленными 
держаться: держался держусь 
выдыхать: выдыхаешь 
январь: января 
бошка: бошку 
сложно: сложно 
лизер: лизер 
махать: машет 
промокомпания: промокомпании 
возглас: возгласы 
сгореть: сгорели 
хороший: хороша лучший лучшее хороший 
связанный: связанный 
запись: запись 
ри: ри 
касание: касание 
роль: роли 
нарисовать: нарисуешь нарисуй нарисован 
пульс: пульс 
соврать: соврал соври 
девятьсот: девятьсот 
шлюха: шлюха шлюхой 
старик: старикам 
давно: давно 
иллюминатор: иллюминаторы 
собачий: собачий 
техно: техно 
забыть: забудем забуду забыть забыв забыл забудь забыла 
инстаграм: инстаграме инстаграм 
радикально: радикально 
пить: пили пью пить 
развеять: развеют 
повзрослеть: повзрослела повзрослею 
смешной: смешон 
понравиться: понравилась понравилось понравится 
сильный: сильнее сильный сильней 
тяжко: тяжко 
отсосать: отсосать отсоси 
ловить: ловят ловить ловит ловлю 
делить: делят делишь 
нолик: нолик 
туалет: туалете 
испортить: испорчу 
серый: серая 
сравнение: сравнение 
ничья: ничью 
чокер: чокер 
отшельник: отшельник 
душевный: душевный 
панч: панч 
замереть: замерла 
туфля: туфлях туфли 
куст: куст 
жить: жить жили живёшь живу 
шум: шум 
наруто: наруто 
клим: клим 
тупик: тупик 
мираж: мираж 
пачкать: пачкает 
разорвать: разорвав 
упс: упс 
бридж: бридж 
множество: множество 
прикрепить: прикрепив 
начать: начал начали начать 
тусклый: тусклый 
пропустить: пропустил пропущенных 
вибрировать: вибрирует 
трудно: трудно 
взаимно: взаимно 
приятель: приятель 
сахарный: сахарная сахарный 
дуть: дуй 
круча: кручу 
взр: взры 
исход: исходе 
увы: увы 
гон: гон 
яй: яй 
дискорд: дискорде 
взрыв: взрыв 
грубо: грубо 
проект: проект 
лесбух: лесбуху 
слабо: слабо 
отдать: отдал отдай отдала 
шесть: шесть 
приоткрыть: приоткрыть 
слякоть: слякоть 
принцип: принципе 
лейн: лейн 
неизданный: неизданная 
погулять: погулять 
мелодия: мелодия 
липучка: липучкой 
егор: егор 
показать: покажи покажу показали показан показал 
пройти: прошли пройдёт прошёл прошло 
столько: столько 
ставить: ставлю ставил 
водка: водку водка 
долбить: долбил 
щека: щекой 
кисун: кисун 
заря: зари 
бля: бля 
угол: угол угла 
вина: виной 
мокрый: мокрые 
игра: игр игре игра игру 
менять: меняю меняй 
приносить: приносят 
отменять: отменяй отменяет 
порез: порезы 
рюкзак: рюкзаке 
поним: понима 
исполнить: исполнена исполнили исполнены 
жалеть: жалел 
чёрт: чёрт 
кстати: кстати 
ответить: отвечу ответь ответить 
пушка: пушка 
баффа: бафф 
сон: снов сна снах сон сны сном 
ау: ау 
вновь: вновь 
блядь: блядь блять блядей 
рента: рент 
сердце: сердца сердце сердцем 
похоть: похоть 
лезть: лезть лезет лезь 
лис: лис 
работа: работы работу работа 
чемодан: чемоданом чемоданы 
сначала: сначала 
пятно: пятна пятно 
акула: акула акулы 
сумма: сумма сумм 
хентай: хентай 
объект: объект 
следовать: следовал 
стесняться: стесняюсь стесняться 
зарядка: зарядка 
мьют: мьюту 
диссит: диссит 
беспроводный: беспроводная 
спросить: спроси 
молчать: молчи молчу молчать 
мило: мило 
свернуть: сверну 
автор: автора автор 
сидеть: сижу сидел сидеть сидит 
плакать: плачешь плачь плачет плакать 
карман: кармане карманах карманы 
объебаться: объебаться 
краситься: красится 
семья: семья семьи семью 
пьяный: пьян 
потеплеть: потеплей 
пилигрим: пилигрима 
простить: простить прости 
многие: многие 
исправить: исправить 
молотый: молот 
доступ: доступа 
приобрести: приобретённой 
впоследствии: впоследствии 
узнать: узнала узнал узнали узнаешь узнает узнать 
аэропорт: аэропорту аэропорт 
система: системе 
взгляд: взгляд взгляда взгляду взгляды 
одеть: одеть 
кролик: кролик 
сияние: сияние 
таинственный: таинственный 
прокурить: прокуренная прокурена 
сладкий: сладкая сладкий сладких 
малый: малая малый малой 
мэйбить: мэйби 
копаться: копается 
девка: девка 
пиз: пиз 
кровотечение: кровотечение 
мулен: мулен 
внешне: внешне 
обидеть: обидел 
участие: участие 
уродка: уродка 
дорога: дорога дороги дорогой дорогу дорог 
наизусть: наизусть 
жест: жесты 
договариваться: договариваться 
дохуй: дохуя 
откр: откры 
спасательный: спасательный 
скорее: скорее 
миллион: миллионы 
сдохнуть: сдохнем сдох 
два: две двух 
стрельнуть: стрельнул стрельни стрельнуть 
выпечка: выпечка 
обычный: обычный 
борат: борату 
масса: масса 
масейкин: масейкин 
католик: католик 
татуировка: татуировка 
тянка: тянку 
наркоз: наркоз 
назад: назад 
о: обо 
весьма: весьма 
фладда: фладд 
зависнуть: зависли зависла 
солнце: солнце солнца 
форма: форма 
скучный: скучнее 
врать: врёшь врать врёт 
прямо: прямо 
хм: хм 
некий: некий 
вдохновляться: вдохновлялся 
ха: ха 
поход: походы походов походу 
забивать: забивай 
посмотреть: посмотрим 
попкорн: попкорн 
получить: полученные получить получил 
доджить: доджишь 
изрисовать: изрисуем 
втра: втра 
решать: решаю решает 
идё: идё 
гроб: гроба 
утром: утром 
аниме: аниме 
фэн: фэны 
эпизод: эпизодом эпизод 
вор: вор 
бывший: бывшей 
лифчик: лифчик 
застрелить: застрелил 
мужик: мужик 
порше: порше 
руслан: руслан 
сеть: сеть сети сетью 
интимка: интимки 
душа: душе душу 
таблетка: таблетка таблетки таблеток 
крючок: крючок 
дуб: дуб 
устроить: устроил устроим 
психолог: психологу 
счастливый: счастливые счастливой счастливый 
бодипозитив: бодипозитив 
край: краем краю 
оттенок: оттенок 
обезболить: обезболь 
покушать: покушаешь покушал 
битва: битва 
юзаесть: юзаем 
отличие: отличие 
двигаться: двигаюсь 
довозить: довожу 
этот: этих этому эта 
анхолдеть: анхолдит 
выпустить: выпущен выпустил 
любить: любят любишь люби любит любила любить любил люблю 
скрывать: скрывают 
ключ: ключ 
короткий: короткое короткая 
поцелуй: поцелуев поцелую поцелуи 
превращать: превращаю 
грация: грация 
кобыла: кобыла 
квадратный: квадратную 
аванс: аванс 
секс: секс секса 
кайф: кайф 
процесс: процессе 
шорты: шорт 
ситуация: ситуацию ситуацией ситуации 
бензиновый: бензиновый 
пятница: пятницы 
ваза: ваза 
любитель: любитель 
схавал: схавал 
увидеть: увидишь увидели увидев увидеть увижу 
интерес: интерес 
нести: нести несут несу несёт 
ледяной: ледяную 
алекс: алекс 
включить: включил включу 
ослеплять: ослепляют 
захар: захар 
проникать: проникаю 
мышка: мышка 
время: время времени 
вскрыть: вскроем 
эйдман: эйдман 
убиваться: убиваюсь убивается 
ялрс: ялрс 
погода: погоды 
ать: ать 
иванов: иванов 
замечать: замечаешь замечаю 
койл: койл 
куплет: куплет куплетах куплеты 
афродита: афродита 
сказка: сказка 
копа: копа 
ухо: уши ушах 
юбка: юбка 
халат: халат 
спасти: спаси спасёт спас 
прям: прям 
макинтош: макинтош 
здорово: здорово 
делать: делаешь делают делать делаю делал делает 
цель: цель 
фиолетовый: фиолетовые 
карандаш: карандашу 
пронестись: пронеслась 
усыпать: усыпан 
опасно: опасно 
печать: печати 
глупо: глупо 
кореш: кореш 
солистка: солистке 
невнимательно: невнимательно 
удалить: удалить 
сторонка: сторонке 
вмазать: вмазанная 
предлагать: предлагали 
речка: речке речка 
инст: инсте 
битый: бит 
разрешение: разрешение 
хилка: хилка 
встречаться: встречаются 
решить: решить решено решила решил 
кофта: кофтой кофты 
двое: двоих 
вставать: вставать вставай 
двойственный: двойственный 
родинка: родинки 
биониклый: бионикл 
фенди: фенди 
тимур: тимур тимуром 
например: например 
сольный: сольный 
спасть: спал спала спали 
прибор: приборы 
угорать: угораете угораю 
застрять: застрял 
точность: точность 
миксовать: миксую 
готовый: готовы готова готово готов 
надуть: надула 
человеческий: человеческий 
плохой: плохом хуже плохой 
рыдать: рыдать 
руж: руж 
аптека: аптекой 
посылать: посылает посылаю 
ярко: ярко 
оппа: оппы 
пост: пост 
флоу: флоу 
шляться: шлялась 
дурочка: дурочках 
аренби: аренби 
деталь: деталям 
ремесло: ремесло 
искушение: искушения 
айфон: айфон 
занять: заняла занял заняло занять 
шь: шь 
простой: проста простым прост 
страдать: страдала страдать 
заплакать: заплакать 
рейв: рейв 
повторяться: повторяется 
крошиться: крошусь 
грузинский: грузинский 
поэтому: поэтому 
пло: пло 
танец: танцы 
сумка: сумках сумке 
кабель: кабель 
задача: задачи 
цифра: цифр цифры 
фото: фото 
волос: волосами волосы волосах 
напалм: напалм 
звучать: звучит 
экземпляр: экземпляр 
забывать: забываю забывать забывала забывая 
бросать: бросает бросаешь 
стадия: стадии 
конц: конц 
бить: бьёт 
мрак: мраке 
немного: немного 
суметь: сумел 
горе: горю 
обмануть: обманул обманешь 
вк: вк 
др: др 
гла: гла 
желание: желанием желания желание 
хейтеры: хейтеры 
трястись: трясутся 
жирный: жирный 
сравнимый: сравнима 
меняться: меняться меняюсь 
еда: еду 
чш: чш 
заработать: заработал заработанные 
правда: правда правду правды 
выходить: выходил выходит 
побыть: побудь 
кинотеатр: кинотеатр 
происходить: происходящей происходит 
налить: налей налить 
поехать: поеду 
гоняться: гоняется 
поджечь: поджечь подожгу 
минус: минус 
мимо: мимо 
кока: кока 
стоить: стоит стою стоило стой 
мурасакибар: мурасакибара 
тоска: тоска тоски 
ля: ля 
нырять: ныряю 
бардак: бардак 
закат: закат 
воздух: воздух 
застывать: застывает 
битмейкер: битмейкер битмейкера 
вес: вес 
произойти: произошло 
прекращать: прекращать 
диана: диана 
изображение: изображение 
заходить: заходит 
заткнуть: заткну 
игривый: игривого 
метель: метель 
хабар: хабаров 
круг: круг кругу круги кругами 
зажигалка: зажигалка 
бр: бр 
семьдесят: семьдесят 
фиби: фиби 
проклятый: проклятую 
поёбиться: поёбёмся 
замыкание: замыкание 
след: следы следам 
значок: значки 
ремикс: ремикс 
самолёт: самолёт 
драгс: драгсы 
тяжело: тяжело 
отсос: отсосу 
монохромный: монохромен 
ненавидеть: ненавижу ненавидишь ненавидят 
невозможно: невозможно 
зависимый: зависима 
оставлять: оставляя 
манить: манит 
афиша: афише 
пожалуй: пожалуй 
флойда: флойд 
пахнуть: пахнет 
квартира: квартире квартиры 
симп: симп 
баскетбол: баскетбола баскетбол 
холод: холода холод 
вибратор: вибратор 
залететь: залетит 
вырывать: вырываю 
дайка: дайки 
наполнять: наполняет 
чупс: чупс 
схапать: схапал 
пр: пр 
стака: стака 
монтаж: монтаж 
сырой: сырая 
ломать: ломаю ломает 
зак: заки 
рана: рану раны 
драйвер: драйвер 
пелена: пеленой 
нос: нос носом 
табак: табака 
король: король 
рнб: рнб 
параноить: параноит 
снизу: снизу 
покебола: покеболе 
телеграм: телеграм телеграме 
расцвести: расцвела 
уёбкома: уёбком 
шкушка: шкушку 
зажечься: зажгутся 
изменять: изменял изменять изменяю 
еть: еть 
шпион: шпион 
выполнять: выполняй 
пластырь: пластырь 
выглядеть: выглядит выглядела выгляжу выглядишь 
хоу: хоу 
глотать: глотай 
звать: звала зовут зовёт зови 
прыгнуть: прыгнул 
фура: фуре 
максим: максим 
скука: скука 
поддаваться: поддаётся 
лёгкое: лёгкие 
двусмысленный: двусмысленно 
меж: меж 
видеоролик: видеоролика 
тюбик: тюбик 
общение: общении общение 
неправда: неправда 
вылезти: вылезет 
долбоести: долбоёб 
стадионный: стадионно стадионная 
фрэндс: фрэндс 
закрытие: закрытие 
умирать: умирает умираю 
миг: миг 
пята: пятам 
портфолио: портфолио 
магия: магия магии 
плазма: плазма 
ма: ма 
сохранить: сохранить 
грусть: грусть 
сфотографировать: сфотографирую 
хейтить: хейтят 
замо: замо 
горлышко: горлышко 
чокопать: чокопай 
катафалк: катафалк 
повезти: повезло 
схожий: схожий 
предложить: предложили 
сдёрнуть: сдёрни 
лобик: лобик 
меланхолия: меланхолия 
сбежать: сбежим 
мерс: мерс 
броук: броук 
заново: заново 
бумбокс: бумбокс 
ползти: ползёт 
филлер: филлер 
мыслить: мыслю 
ебучий: ебучий 
джонни: джонни 
набор: набор 
брать: берём беру брать 
разрушить: разрушить 
одновременно: одновременно 
чувствовать: чувствуешь чувствовала чувствую чувствовал чувствовать 
разлюбить: разлюбит 
зрачок: зрачки 
неверно: неверно 
появиться: появился появились 
вскоре: вскоре 
видеоработа: видеоработа 
утонуть: утону утонуть утонет 
сучок: сучку 
лола: лол 
чуять: чую 
также: также 
инстаграмм: инстаграмм 
пустышка: пустышка 
сложный: сложный 
заявка: заявку 
ой: ой 
наушник: наушниках 
ненависть: ненависть 
воровать: воруют 
диалог: диалог 
лечить: лечит 
тревога: тревога 
стиль: стиля стиле стиль 
одеваться: одевайся 
мицелярка: мицелярку 
аомина: аомине 
колено: коленях колени 
ботинок: ботинки 
хэлт: хэлта 
жопа: жопе жопа жопу 
экзамен: экзамен 
юди: юди 
анонсировать: анонсировал 
сок: сок 
ваш: ваши ваша ваш ваше 
плевок: плевок 
мокасин: мокасины 
лишь: лишь 
отличный: отличный 
физический: физические физическая 
фаббер: фаббер 
тобо: тобо 
грядущий: грядущему грядущего 
максимум: максимум 
майот: майотом 
полночь: полночь 
вечно: вечно 
закатать: закатаны 
недоступный: недоступна недоступны недоступен 
подставить: подставил 
вода: водой вода воды воду 
слепить: слепил 
строка: строк 
украина: украиной украины 
педофил: педофил 
баланс: баланс 
всунуть: всунул 
полететь: полетишь полетел 
хотя: хотя 
никак: никак 
тишина: тишина тишине тишины 
будущее: будущего будущем 
заблокировать: заблокирую 
медиа: медиа 
разжигать: разжигаешь 
стемнеть: стемнеет 
гаситься: гасится 
красава: красава 
тысяча: тыща тыщах тысяча тысячи тысяч 
блейда: блейды 
восемнадцать: восемнадцать 
заести: заебла 
робот: робот 
злой: злые 
повиснуть: повис 
сиповать: сипую 
алло: алло 
обман: обманом 
легко: легко 
темп: темп 
предположить: предположено 
веко: веки 
блён: блён 
класс: классе классом 
заправлять: заправляю 
отдыхать: отдыхает 
энергетик: энергетик 
триллер: триллер 
слабак: слабак 
дельфин: дельфин 
покой: покоя 
массовка: массовки 
горячий: горяча 
особо: особо 
вниз: вниз 
загрузить: загружена загрузил 
мурчать: мурчишь мурчит 
бог: бога боже 
высохнуть: высохнет 
улёт: улете 
статус: статуса 
верный: верен 
анаболик: анаболик 
считать: считал считать считаю 
следующий: следующее следующий 
повториться: повторилось 
лина: лин 
тридцать: тридцать 
ломка: ломка 
темно: темно 
посадочный: посадочные 
ссора: ссоры 
аполлон: аполлон 
б: б 
номер: номера номер номеру 
из: изо 
ят: ят 
тя: тя 
мадемуазель: мадмуазель 
фобия: фобий 
спродюсировать: спродюсировавший 
саня: саня 
передоз: передоз 
просьба: просьбу 
жать: жмёшь 
детка: детку детка 
сэккс: сэккс 
проводить: провожу 
плед: плед 
туповатый: туповата 
вход: вход 
разлучить: разлучить 
эскорт: эскорта 
снегопад: снегопад 
садиться: садись сажусь 
элис: элис 
пообещать: пообещай 
здоровье: здоровье 
звонок: звонки звонка 
обед: обед 
четыре: четырёх четыре 
пустота: пустота 
нежно: нежно 
выходка: выходки 
встретиться: встретимся 
охрана: охрана 
несколько: несколько 
мефа: мефа 
курить: куришь курю курить 
загадать: загадаю загадал 
фара: фарой 
котик: котики котик 
прекрасный: прекрасен прекрасная 
растопить: растопишь 
эйфория: эйфория 
тень: тени тень 
разум: разум 
закон: закон 
соус: соус 
хе: хе 
бя: бя 
нло: нло 
выпускать: выпускал выпускать 
корона: корона 
ести: ебёшь ебёт 
сумерки: сумерки 
так: т 
худить: худи 
штора: шторы 
николай: николай 
окей: окей 
проц: проц 
задом: задом 
хина: хины 
бедро: бёдра 
разбежаться: разбежались 
потолок: потолок 
мяч: мяч 
знак: знак 
драма: драма 
приземлить: приземлило 
кроссовок: кроссовки 
откусить: откусить 
бороться: бороться 
идея: идее идея 
слушать: слушай слушать слушал слушая 
кипеть: кипит 
трапа: трапой 
ик: ик 
солнышко: солнышку 
ублюдок: ублюдок 
подружиться: подружились 
выносить: выношу 
хапать: хапаю 
пиздец: пиздец 
обменять: обменять 
мощный: мощнейшая 
погибнуть: погибну погиб 
грязь: грязь 
пополам: пополам 
открытый: открытый 
буква: буквой букву 
оттуда: оттуда 
мак: мак 
атмосфера: атмосфера 
жечь: жгу 
леонид: леонид 
часики: часики 
зая: зая 
принцесса: принцесса 
переживать: переживай 
хватить: хватит хватило хвати 
праздник: праздников праздник 
чёс: чес 
космический: космический 
интервью: интервью 
курение: курение 
правильно: правильно 
летать: летают летать летаю летал летай летает летали летаем 
обойти: обошёл 
пра: пре 
приблуд: приблуду 
листва: листва 
состояние: состояние 
водичка: водичка 
поп: поп 
поделиться: поделился поделиться 
апрель: апреля 
труп: труп 
лесть: лести 
стук: стука 
попадать: попадая попадаю попадает 
хач: хач 
всё: всё 
водопад: водопад 
безумно: безумно 
пролить: пролил 
карьера: карьеру 
повод: поводу повод повода 
оказаться: оказался окажемся оказаться 
сервер: сервера 
попросить: попросишь 
подвал: подвал 
дурь: дурь 
сомневаться: сомневаюсь 
животик: животик животике 
ячмень: ячмень 
лёгкий: лёгких легкая 
любой: любом 
японский: японского 
помолчать: помолчим 
суперпоросёнок: суперпоросенок 
удаль: удали 
пожирать: пожирают 
детство: детства 
крепко: крепко 
написание: написании 
уиу: уиу 
широта: ш 
хватать: хватает 
пускай: пускай 
начаться: началось 
генг: генг 
четверг: четверг 
неважно: неважно 
мусор: мусор 
характер: характер 
слышь: слышь 
рифма: рифму 
ряд: ряд 
аккаунт: аккаунт 
мамэтотолькодляфото: мамэтотолькодляфото 
шанс: шанс 
сниппет: сниппетами 
оба: оба 
дитя: дитя 
переходить: переходи 
просыпаться: просыпаюсь просыпаться 
сыр: сыр 
поблагодарить: поблагодарить 
ебу: ебу 
неа: неа 
космос: космос 
посетить: посетив 
плюшевый: плюшевый 
красть: краду 
океан: океана океаны океан 
цепь: цепи цепями 
дропнуться: дропнется 
читать: читают 
шрам: шрамы 
оценить: оценил оцени 
привязь: привязь 
ванна: ванне 
держать: держи держал 
записывать: записывал записываю 
мальдивы: мальдивы 
суккуб: суккуб 
жертвовать: жертвуй 
исполнять: исполняет 
достаточно: достаточно 
зипхудить: зипхуди 
тец: тецу 
покрыть: покрыть 
поглощать: поглощать 
затмевать: затмевают 
ватный: ватные 
домой: домой 
прямой: прямом 
одинокий: одинокий одинок 
бенгера: бенгер 
есть: ест 
мульт: мульта 
чувак: чувак 
россия: россии россия россией 
орган: органов 
наз: наза 
бесконечный: бесконечное 
паранойя: паранойя 
начинать: начинал начинай начинает начинаете 
звук: звук 
поток: поток 
адекватно: адекватно 
разбить: разбил разобью разбить 
го: го 
объявить: объявил 
уверенность: уверенности 
мягкий: мягкий 
кофе: кофе 
этаж: этаж 
сокрушить: сокрушу 
картина: картине картины 
ала: ал 
ради: ради 
баста: бастой 
холодное: холодное 
ещё: ещё 
интернет: интернете интернет 
обходить: обходила 
залезать: залезаю 
салют: салют 
давочко: давочка 
капа: капе 
недосягаемый: недосягаема недосягаем 
оплатить: оплатил оплатит 
пустой: пустых пуст пустые пустая пустой пуста 
взаимный: взаимная 
повторимый: повторим 
стать: стала станешь стали стало стану стал стать станет 
макуха: макуха 
вертушка: вертушка 
студия: студия студии 
отправить: отправлен 
фантом: фантом 
опытный: опытных 
добби: добби 
бизнесмен: бизнесмен 
резать: режет режут 
бросок: бросок 
рада: рады 
ноябрь: ноября 
вылезать: вылезаю вылезают 
атомный: атомная 
фистинг: фистинг 
антикобыла: антикобыла 
коллаборация: коллаборация 
близнец: близнец 
замучить: замученный 
убитый: убитый убитые 
дурак: дурак 
хиросима: хиросимы 
пробыть: пробыть 
ю: ю 
размещать: размещал 
вредный: вреднее 
небезопасный: небезопасная 
ритм: ритм 
засунуть: засунь засуну 
токо: токо 
щель: щель 
справиться: справлюсь справимся 
снежок: снежок снежки 
ребёночек: детками 
хайперпоп: хайперпоп 
ле: ле 
зато: зато 
футболка: футболка футболку 
значение: значение 
дрянь: дрянь 
лес: лесу 
ва: ва 
внизу: внизу 
ончить: ончу 
ум: ума уме 
ря: ря 
крыть: крыть 
скользь: скользи 
па: па 
дикий: дикий 
попытка: попытки 
норма: норме 
мебель: мебель 
инстинкт: инстинкт 
знай: знае 
привлекать: привлекает 
вконтакте: вконтакте 
бро: бро 
коробка: коробок 
повторюшка: повторюшка 
дабла: дабл 
треклист: треклист 
банда: банда 
разрешать: разрешает 
мысль: мысли мыслями 
ощущение: ощущений 
жвачка: жвачка 
дакимакур: дакимакура 
второй: вторая второй вторые 
чехарда: чехарда 
закрывать: закрываю закрывает 
сегодня: сегодня сёдня 
сообщать: сообщает 
описывать: описывает 
привычка: привычка 
спасибо: спасибо 
возраст: возраст 
ги: ги 
мкад: мкад мкадом 
сие: се 
дерзить: держу 
оффсный: оффсен 
блик: блики 
синига: синигами 
седьмой: седьмой седьмое 
измена: изменах 
бэйбить: бэйби 
фу: фу 
выбрать: выберу выбрал 
ух: ух 
неправильно: неправильно 
х: х 
валентин: валентин 
видимо: видимо 
джинс: джинс 
интрига: интриге 
короче: короче 
кэш: кэш 
скорый: скором скорей 
эмоция: эмоции 
растение: растения 
гда: гда 
гидрант: гидрант 
вдыхать: вдыхать вдыхаешь вдыхаю вдыхай 
робкий: робок 
бум: бум 
ёд: ёд 
коридор: коридоре 
билли: билли 
алименты: алименты 
снаружи: снаружи 
заебал: заебал 
намного: намного 
продюсер: продюсер 
существовать: существуют существует 
математик: математика 
ахахи: ахахах 
снупчик: снупчик 
довериться: доверюсь 
встать: встанем встать 
з: з 
паразит: паразит 
атом: атомы 
занавеситься: занавесятся 
она: нею неё 
нихуй: нихуя 
неуверенность: неуверенности 
выпрыгнуть: выпрыгнем 
лайк: лайки 
вперёд: вперёд 
перевязать: перевязанные 
утопать: утопаю 
вполне: вполне 
свет: свет 
бесплатный: бесплатного 
подробный: подробнее 
ранить: ранить 
воля: воли 
оно: оно 
заскамил: заскамил 
рудич: рудич 
победить: победить 
порт: порт 
наверняка: наверняка 
обвести: обведи 
наскамил: наскамил 
телеграмма: телеграмм телеграмма 
превратить: превратили 
въебаться: въебаться 
видно: видно 
покурить: покурить покурим 
сэмпл: сэмпл 
сироп: сироп 
наверно: наверно 
тащить: тащу 
аллигатор: аллигаторы 
коннектить: коннектим 
мадам: мадам 
замечательный: замечательная 
прэ: прэ 
крутиться: кручусь 
колготки: колготки 
залипать: залипаю 
платина: платина 
коннект: коннекты 
артём: артёма 
повторять: повторяя 
вируситься: вируситься 
близко: близко 
стёртый: стёрты 
влюбить: влюблён 
отрицание: отрицания 
манекен: манекены 
обсуждать: обсуждают 
пересекаться: пересекались 
простуда: простуда 
повторить: повторишь 
предприпев: предприпев 
ага: ага 
потап: потап 
совесть: совестью 
паника: паники 
дешёвый: дешевле подешевле дешёвое 
депутат: депутат 
метаться: мечется 
голый: голую голые 
сэкономить: сэкономил 
циклично: циклично 
бессердечный: бессердечна 
чупа: чупа 
ишка: ишка 
аквариум: аквариум 
полностью: полностью 
принадлежать: принадлежат 
урок: уроков 
сложность: сложности 
въехать: въехал 
педаль: педаль 
ценить: ценила 
реальность: реальность 
тонус: тонусе 
исполнительница: исполнительница 
обрести: обрёл 
хаслить: хаслю 
рыба: рыба 
контур: контур 
рехаб: рехаб 
прежде: прежде 
дарить: дарить 
ликонтина: ликонтин 
краш: крашу 
китай: китая 
максимально: максимально 
скачать: скачаю скачал 
поха: поху 
опустошать: опустошает 
выбрасывать: выбрасываю 
стекло: стекло стекле 
рём: рём 
подняться: поднялись поднялся 
уничтожительный: уничтожительных 
алишер: алишер 
небо: небо неба небе 
толкать: толкают 
буста: буст 
начинаться: начинается 
курс: курсе курсы 
сопряжение: сопряжения 
листать: листаю 
целый: целую целый 
достойный: достоин 
дрова: дров 
выпить: выпил выпила 
несчастный: несчастным 
личный: личная 
срок: сроки 
спиппеть: спиппет 
скоро: скоро 
очередной: очередная 
сан: сан 
яма: яма 
благодаря: благодаря 
сла: сла 
вечный: вечном вечен 
яу: яу 
мнить: мни 
траур: траур 
орёл: орёл 
взлететь: взлетел 
маста: масте 
вырезать: вырезаю 
обжигать: обжигает 
голубой: голубом 
зацепить: зацепила 
флёша: флеш 
рад: рад 
силуэт: силуэт 
блэйдраннэр: блэйдраннэр 
малина: малина 
подпустить: подпущу 
ак: ак 
ненадолго: ненадолго 
хината: хината 
вспышка: вспышек 
удалённый: удалён 
ебало: ебало 
евангелиона: евангелион 
зверь: зверь 
сливаться: сливаюсь 
наркоман: наркоман 
дыра: дыры дыра 
переписка: переписок 
мигалка: мигалки 
сразу: сразу 
кулиса: кулис 
многогранный: многогранными 
легендарка: легендарка 
закопать: закопай 
дружить: дружить 
предок: предкам предков 
знание: знаний 
мид: мид 
глазок: глазки 
бэйс: бэйс 
двоичный: двоичный 
петь: поёт 
амин: амина 
растоптать: растоптанными 
брокколи: брокколи 
основа: основу 
тетрадка: тетрадке 
двойной: двойной 
тик: тик 
заебут: заебут 
измениться: измениться 
вампирский: вампирский 
кр: кр 
враньё: вранье 
часто: часто 
добавить: добавлю 
мастерство: мастерство 
согревать: согревает 
лужа: луже 
холодно: холодно 
герой: героями 
музыкальный: музыкальные 
дура: дура 
скотт: скотта 
получать: получаешь 
срубить: срубил 
доделать: доделал доделать доделан 
переехать: переехал 
композиция: композиции композицию 
выгнать: выгоню 
степанов: степановой 
свысока: свысока 
шип: шипы 
дан: дане 
выбор: выбор 
постель: постель 
базарить: базарю базарит 
бездельник: бездельник 
февраль: февраля февраль 
дождик: дождик 
бремя: бремя 
ударный: ударные 
украсть: украл 
даня: даня 
лук: лук 
ребро: ребром 
олень: оленем 
бнутаить: бнутая 
защита: защиты 
надеяться: надеюсь 
либо: либо 
р: р 
искусать: искусанными 
дымный: дымные 
взорвать: взорвала взорвать 
одиночество: одиночество 
полетать: полетаем полетать 
мучить: мучает мучаем 
корпоратив: корпоратив 
котэ: котэ 
приз: приз 
пикси: пикси 
видео: видео 
ах: ах 
сунуть: сунул 
символизировать: символизирует 
мел: мелом мела 
влияние: влияние 
живот: живот животе 
костёр: костёр 
фраза: фраза 
песочный: песочный 
развыёбываться: развыёбывался 
параллельный: параллельных параллелен 
поцеловать: поцеловал 
наивный: наивный 
запах: запах 
жоас: жоас 
трим: трим 
дёргать: дёргает 
изменить: изменишь 
улица: улицу улице улица 
видать: видать 
ешка: ешка 
кошкодевочка: кошкодевочек 
наверное: наверное 
приветствие: приветствие 
июль: июля 
среди: среди 
ес: ес 
персонаж: персонаж 
сверху: сверху 
хук: хук 
восьмибитный: восьмибитный 
дима: дима 
полгода: полгода 
облегчить: облегчить 
километр: километры 
лом: лом 
вещество: вещества 
вечеринка: вечеринка 
астрал: астрал 
ф: ф 
обида: обид 
тимати: тимати 
толк: толка 
трава: травы 
дурачить: дурачить 
омск: омске 
постоянно: постоянно 
волна: волне 
наряд: наряд 
лишний: лишним 
музло: музло 
затыкать: затыкаешь 
демон: демоны 
вытереть: вытереть 
сведение: сведение 
море: море 
хит: хит хитом 
трахаться: трахались трахаться 
шагать: шагает 
погружение: погружение 
спасатель: спасателя спасатель 
барин: барам 
фристайл: фристайлом 
м: м 
допить: допито 
терпеть: терпеть терпел 
мутить: мучу 
житель: жителя 
джинсы: джинсы 
наплевать: наплевать 
дядя: дяди дядя 
взглянуть: взгляни 
чай: чай 
заебали: заебали 
че: че 
тыс: тыс 
бэст: бэст 
избавить: избавить избавь 
фоточка: фоточку фоточки 
печальный: печальная 
хром: хрома 
дорн: дорн 
докасаться: докасайся 
дух: духов духом 
отсылка: отсылок 
икс: икса 
папик: папик 
летучий: летучая 
пенить: пень 
принести: принесло 
заменять: заменяет 
покемон: покемонов 
дикси: дикси 
охуенно: охуенно 
парус: паруса 
заценить: заценил зацени 
хриплый: хриплым 
спорткара: спорткар 
главклуб: главклубе 
алмаз: алмазы 
безопасный: безопасный 
изнутри: изнутри 
безответно: безответно 
далее: д 
травка: травку 
джина: джин 
григорий: григория 
фрикс: фрикс 
желудок: желудок 
ше: ше 
барби: барби 
соска: соски 
сигарета: сигарета сигареты сигарет 
влю: влю 
кузьмин: кузьмин 
простыня: простынях 
раздетый: раздета 
диван: дивана 
пластиковый: пластиковые 
прописать: прописал 
занятый: занята занят 
комплект: комплект 
газ: газ 
становиться: становится 
пока: пока 
исполняться: исполнялась 
последний: последний 
лунный: лунные лунный 
фонарь: фонари 
леди: леди 
пушер: пушер 
одетый: одетые 
климлордс: климлордс 
называться: называется 
сатана: сатана 
встретить: встретили встретить 
навык: навыков 
фонтан: фонтан 
владислав: владислав 
новенький: новенькие 
девяносто: девяносто 
воин: воин 
напомнить: напомни 
оу: оу 
пластика: пластика 
ознакомиться: ознакомиться 
взросление: взросления 
хранить: храню 
касаться: касаться касаюсь 
показаться: показалось 
вверх: вверх 
фанатеть: фанатеет 
бандит: бандита 
ничего: ничё 
сообщение: сообщения 
ненастоящий: ненастоящая 
танцевать: танцевала 
привидение: привидение 
кроме: кроме 
ра: ра 
протежения: протежении 
заниматься: заниматься 
скамить: скамишь 
отупелый: отупел 
вне: вне 
подбирать: подбираем 
клей: клеем 
кх: кх 
приостановка: приостановке 
пусть: пусть 
асхат: асхат 
гость: гостях 
уродина: уродина 
тт: тт 
заебало: заебало 
светить: светят 
абсолютный: абсолютны 
дуйсенбий: дуйсенбиев 
ладонь: ладонь 
картон: картон 
сотня: сотни 
роддом: роддом роддоме 
ювелирка: ювелирка 
нахуй: нахуй 
дакимак: дакимаку 
незнакомый: незнакомы 
ох: ох 
наделать: наделал 
яга: ягами 
сходиться: сходится 
зам: заме 
успех: успеха 
смочь: сможет сможешь смог смогу 
вау: вау 
печень: печень 
фант: фанта 
нету: нету 
острота: остроты 
кассета: кассете 
мэйбилишес: мэйбилишес 
ошибка: ошибка 
фея: фей 
эт: эт 
молить: молят 
жизненный: жизненную 
круглый: круглый 
семь: семь 
запястье: запястье 
чатрулетка: чатрулетка 
спиздим: спиздим 
заблудиться: заблудилась 
киборг: киборг 
бескрайний: бескрайняя 
рири: рири 
ссылка: ссылка 
распаковка: распаковка 
ыв: ыв 
флирт: флирт 
док: док 
поддержка: поддержка 
зависимость: зависимость 
киёша: киёши 
стол: столе стол 
окружать: окружали окружают 
наручник: наручники 
переустановить: переустановить 
спаситель: спаситель 
вдвоём: вдвоём 
настроение: настроения 
онли: онли 
утопить: утопи 
обычно: обычно 
ушаков: ушакова 
известно: известно 
представлять: представляю 
лист: лист 
врасплох: врасплох 
забитый: забита 
ужасный: ужасны 
гаврил: гаврилов 
аккуратно: аккуратно 
заинтересовать: заинтересуют 
иначе: иначе 
ебал: ебал 
курнуть: курнул 
детский: детские 
поебиться: поебёмся 
бимера: бимер 
трубка: трубку 
пойло: пойло 
проходить: проходит 
недавно: недавно 
бит: бите 
прошедшее: прошедшем 
грубить: груби 
заплатить: заплатишь 
набирать: набирает набираю 
би: би 
больно: больно 
бег: бегу 
занах: занах 
везде: везде 
яд: яд 
кап: кап 
взрывать: взрываем 
нереально: нереально 
мазать: мажет 
тщ: тщ 
пятый: пятое 
ночь: ночи ночь 
затихнуть: затихнуть 
чипсы: чипсов 
буда: будой 
обожать: обожаю 
фетиш: фетиш 
трахнуть: трахнет трахнул 
смело: смело 
называть: называем 
сотка: сотка 
прислать: пришли 
выёбываться: выёбываться 
сильно: сильно 
укр: укра 
искусственный: искусственного 
почувствовать: почувствую 
бейджик: бейджик 
гущин: гущин 
точнее: точнее 
барда: барда 
крем: крем 
громкий: громкий 
висеть: висим 
похрюкать: похрюкай 
вариант: вариант 
чулочек: чулочках 
разочароваться: разочаруешься 
айсберг: айсберг 
братик: братик 
частый: чаще 
александр: александр 
хамелеон: хамелеон 
понятно: понятно 
декабрь: декабря 
ниоткуда: ниоткуда 
мерч: мерч 
эмоциональный: эмоциональная 
фен: фен 
сгорать: сгораю 
гордость: гордостью 
нежный: нежному 
донат: донат 
выдержанный: выдержанно 
пк: пк 
онлайн: онлайн 
технический: технические 
пмс: пмс 
дть: демо 
трапезник: трапезников 
ба: ба 
зад: зад 
описание: описании 
константин: константин 
краткий: кратчайшие 
королева: королева 
коть: коти 
промый: промо 
стартовать: стартует 
флюорография: флюорография 
ил: ил 
вернуться: вернулась вернусь 
стрим: стриме 
спамить: спамить 
сижок: сижки 
кусочек: кусочкам 
терь: терь 
невозможный: невозможным 
йей: йей 
л: л 
создаваться: создавался 
бездушный: бездушный 
прилипнуть: прилип 
застынуть: застыли 
ейн: ейн 
откашляться: откашлялся 
авторский: авторская 
бу: бу 
намеренный: намерен 
лагерь: лагерь 
сходить: схожу 
капать: капает 
профит: профит 
ювелирный: ювелирный 
платье: платье 
обратно: обратно 
разрешить: разрешишь 
сносить: сносит 
однажды: однажды 
палка: палку 
правый: правой 
токсичный: токсичный 
дешёвенький: дешёвенький 
баночка: баночка 
коса: косой 
осторожно: осторожно 
конфетка: конфетка 
маяться: маялась 
паша: паши 
погодить: погоди 
ноздря: ноздрям 
биться: бьётся 
никуда: никуда 
недовольный: недоволен 
триммер: триммер 
прошлый: прошлом 
страшный: страшный 
родиться: родился 
вылизать: вылизал 
глубокий: поглубже 
уи: уи 
надувать: надуваю 
подтягивать: подтягиваю 
метр: метров 
дно: дна 
коснуться: коснуться 
слабый: слабее 
десять: десять 
убийство: убийство 
проглотить: проглотила 
лядь: лядь 
скит: скит 
груз: груз 
сонный: сонных 
бойчик: бойчики 
густой: густом 
преследовать: преследует 
будить: буди 
мыльников: мыльников 
тайный: тайные 
хвостик: хвостиком 
перейти: перешёл перейдёт 
заня: заня 
зависть: завистью 
трезвый: трезвым 
почерк: почерк 
гараж: гараж 
прежний: прежнему 
кросс: кроссы 
юный: юный 
легально: легально 
исполосот: исполосоты 
ас: ас 
скукота: скукота 
точка: точку 
каспер: каспер 
неопределённость: неопределенности 
опускаться: опускаются 
макото: макото 
твиттер: твиттер 
поисковик: поисковиках 
метро: метро 
ить: ить 
сирена: сирены 
фирма: фирмы 
открытие: открытие 
корзина: корзину 
айдол: айдол 
головной: головной 
вмиг: вмиг 
пластмассовый: пластмассовое 
додик: додик 
рэпый: рэпую 
фонарик: фонарик 
высота: высоте 
клининга: клининг 
ч: ч 
дантист: дантист 
наоборот: наоборот 
ход: ход 
громко: громко 
гриша: гриши 
данк: данк 
рано: рано 
кислота: кислота 
муа: муа 
соло: соло 
суперспособность: суперспособность 
вывозить: вывозит 
цум: цума 
допустить: допустим 
засниппетить: засниппетил 
детски: детски 
июнь: июня 
изя: изи 
слэш: слэш 
мувов: мувов 
кратер: кратеры 
хлам: хлам 
аквадискотека: аквадискотека 
уф: уф 
соваться: соваться 
аборт: аборт 
отказать: откажет 
обыграть: обыграл 
кха: кха 
выебал: выебал 
карамельный: карамельном 
униформа: униформе 
владимир: владимир 
растворяться: растворяюсь 
лоликон: лоликон 
печаль: печали 
н: н 
мало: мало 
полнеть: полнеет 
напрасно: напрасно 
ствол: стволы 
поц: поц 
неписаный: неписаны 
добавлять: добавляют 
подогреть: подогрел 
куроко: куроко 
толпа: толпе 
чердак: чердак 
запутаться: запутался 
рамка: рамках 
вытирать: вытираю 
мельком: мельком 
ай: ай 
мерзкий: мерзкий 
севастьян: севастьян 
смешаться: смешались 
зона: зоны 
троп: троп 
вывод: вывод выводами 
калечить: калечит 
сучка: сучек сучки 
принятие: принятие 
клык: клыки 
неприятный: неприятен 
веселиться: веселитесь 
шарик: шарик 
приближаться: приближается 
плюс: плюс 
фрешмена: фрешмена 
бригада: бригада 
настя: настя 
найда: найд 
энергетика: энергетика 
фейк: фейк фейки 
доживать: доживать 
сколько: сколько 
посинеть: посинеет 
тугельбай: тугельбаев 
ментальный: ментально 
интуитивный: интуитивном 
гринч: гринч 
чел: чел 
укусить: укушу 
перепрятать: перепрятал 
чит: чит 
опускать: опускаю 
нора: норе 
очень: очень 
дуо: дуо 
фри: фри 
забавный: забавным 
дятел: дятел 
престиж: престиж 
безопасность: безопасность 
сливать: сливаю 
дрейновый: дрейновую 
ушко: ушко 
тачка: тачке 
жанр: жанре 
выкиня: выкини 
проблеваться: проблевался 
письмо: письма 
малышок: малышки 
щих: щих 
психиатр: психиатр 
секта: секта 
съебиться: съебёмся 
пять: пять 
сетчатый: сетчатые 
мицуха: мицуха 
ура: ура 
хип: хип 
оставль: оставля 
дриззь: дриззи 
сегодняшний: сегодняшний 
табла: таблы 
трахать: трахаю 
ложь: лжи 
младший: младшего 
разбогатеть: разбогател 
липнуть: липнуть 
подзаря: подзаря 
пейзаж: пейзаж 
физикать: физикал 
долго: долго 
фух: фух 
туса: туса 
восемьдесят: восемьдесят 
быстро: быстро 
говно: говно 
фальшь: фальшь 
чутьё: чутью 
проиграть: проиграла проиграл 
пробовать: пробуй 
палма: палм 
шестьсот: шестьсот 
уби: уби 
крупный: крупная 
ловва: ловва 
наперёд: наперёд 
верно: верно 
стирка: стирка 
лак: лаки 
ыть: ыть 
молодёжь: молодёжь 
сквор: сквор 
монтана: монтана 
бочка: бочку 
разрушиться: разрушилась 
дре: дре 
плаг: плаг 
низ: низ 
золотарёв: золотарев 
вокруг: вокруг 
панцирь: панцирь 
почему: почему 
снег: снег 
врач: врачу 
крутой: круче 
сно: сно 
рудольф: рудольф 
шапочка: шапочка 
азарт: азарта 
ки: ки 
ода: од 
факт: факт 
перевод: переводы 
сжечь: сожги 
дозвониться: дозвониться 
доверять: доверять 
неинтересный: неинтересно 
гетто: гетто 
появляться: появляется 
трогать: трогаю 
хоп: хоп 
пое: пое 
раствориться: растворюсь 
хикк: хикка 
мокнуть: мок 
филипп: филипп 
смс: смс 
плечо: плечом 
девять: девять 
слезать: слезает 
супермаркет: супермаркет 
выкурить: выкурить 
хрюшка: хрюшка 
шоколадка: шоколадки 
кома: коме 
ким: ким 
бороздить: бороздил 
сорить: сори 
скёлтый: скелта 
слишком: слишком 
именно: именно 
килограмм: килограмм 
ровер: ровер 
неделя: неделю 
нигде: нигде 
жалко: жалко 
костюм: костюм 
свесить: свесил 
властелин: властелин 
кнопка: кнопка 
инет: инета 
взаимность: взаимности 
рэй: рэй 
сей: сих 
останкино: останкино 
страшно: страшно 
фокус: фокусы 
получаться: получается 
открывать: открываю 
хочуспать: хочуспать 
