проблема: проблем 
домой: домой 
застрять: застрял 
дерево: дерева дереве 
поблагодарить: поблагодарить 
дохуй: дохуя 
четыре: четырёх 
ёбаный: ёбаных 
идти: идёт 
общий: общем 
чёрный: чёрная чёрный черный 
интро: интро 
даня: даня 
вечно: вечно 
поп: поп 
кот: кот кота 
почему: почему 
всё: всё 
русский: русский 
этот: этих 
россия: россия 
думать: думать 
припев: припев 
я: мной 
бридж: бридж 
башка: башке 
ак: ак 
мой: моей 
хотеть: хочу хочет 
спасать: спасать спасал 
перейти: перешёл перейдёт 
дорога: дорогу 
куплет: куплет 
ещё: ещё 
свой: своих 
взять: взять 
прийтись: придётся 
стена: стена 
барда: барда 
спасти: спас спаси 
ах: ах 
это: это 
хайперпоп: хайперпоп 
пята: пятам 
полоса: полоса 
аутро: аутро 
казаться: кажется 
нести: несёт 
текст: текст 
гора: горе 
тот: та 
песня: песни 
постприпев: постприпев 
виноватый: виноват 
ум: ума 
блин: блин 
сходить: схожу 
