дырка: дырку 
слышать: слышал 
твой: твоим твои твоя твой 
рот: рту рот 
чел: чел 
покушать: покушаешь покушал 
чёлка: чёлкой 
рэп: рэп 
животик: животике 
навсегда: навсегда 
пойти: пойдёт пошёл пойдём 
мужик: мужик 
миксовать: миксую 
наливать: наливаю 
всё: всё 
голубой: голубом 
киска: киску 
русский: русский 
говорить: говорит 
ты: тебе 
стик: стике 
папик: папик 
помнить: помню 
водичка: водичка 
обходить: обходила 
поджигать: поджигаю 
угорать: угораю 
верить: веришь 
поднять: поднимешь 
банда: банда 
хотеть: хочу хочет 
тёлка: тёлка 
краш: крашу 
смотреть: смотрю 
трек: треки 
зато: зато 
обещать: обещал 
часы: часах 
голова: голова 
дротик: дротики 
наш: наша 
мицелярка: мицелярку 
отец: отцом 
мэри: мэри 
это: это 
съебаться: съебался 
хуй: хуй хуями 
бро: бро 
лить: лью 
платье: платье 
живот: животе 
увидеть: увидишь 
гладить: глажу 
весь: весь 
хвататета: хвататет 
тапка: тапки 
ебу: ебу 
сила: силой 
маленький: маленький 
детка: детка 
малышка: малышка 
готовый: готовы 
пушка: пушка 
встать: встанем 
пуля: пуль 
удаль: удали 
палить: палят 
рано: рано 
бабка: бабки 
утащить: утащу 
родинка: родинки 
стать: стала стал 
нету: нету 
искать: ищет 
пожелать: пожелать 
день: дня 
сегодня: сегодня 
голый: голую 
реальный: реальный 
трэп: трэп 
новый: новые 
выебал: выебал 
менять: меняю 
некрасиво: некрасиво 
минута: минут 
сильно: сильно 
джина: джин 
такой: таким 
тупо: тупо 
жопа: жопе 
яркий: ярче 
думать: думай думала 
пробить: пробьёт 
быть: буду будь е 
вдуть: вдуй 
котёнок: котёнка 
знать: знаю знает 
выглядеть: выгляжу 
боль: боль 
вскоре: вскоре 
аутро: аутро 
поменять: поменяло 
банк: банк банком 
текст: текст 
фонтан: фонтан 
песня: песни 
вообще: вообще 
понять: понял 
звать: зовёт 
попросить: попросишь 
лицо: лицо 
тип: типа 
фа: фа 
уйти: ушёл 
очень: очень 
красить: красит 
хуйня: хуйнёй хуйню 
платёж: платежи 
ротик: ротик 
снежинка: снежинках 
чудо: чудеса 
кровать: кровать 
всякий: всякой 
сунуть: сунул 
мама: мама 
исчезать: исчезаю 
вряд: вряд 
подносить: подношу 
ха: ха 
сука: сука 
флоу: флоу 
слушать: слушал 
богатый: богатым 
россия: россия 
точно: точно 
ёбаный: ебаные ёбаный 
рука: рук руку 
купить: купил куплю 
дышать: дышим 
слеза: слёз 
ф: ф 
тт: тт 
куплет: куплет 
кх: кх 
палец: палец 
делать: делает делать 
сейчас: ща 
что: чё чём 
пройти: прошёл 
грязный: грязная 
дуть: дуй 
хайперпоп: хайперпоп 
папа: папа 
легендарный: легендарное 
уродина: уродина 
петь: поёт 
пф: пф 
идти: иди 
утонуть: утону 
хаслить: хаслю 
вау: вау 
воу: воу 
к: ко 
давать: даёт даю 
додикий: додики 
мульт: мульта 
мочь: можешь могу 
мусор: мусор 
э: э 
двадцать: двадцать 
ждать: жду 
подруга: подруги 
фант: фанта 
точка: точку 
крыть: крыть 
течь: течёт 
понимать: понимает 
насувал: насувал 
спрятать: спрятаны 
вылезти: вылезет 
ру: ру 
оплатить: оплатил 
корзина: корзину 
пиздить: пиздить 
нести: несу 
полночь: полночь 
часть: часть 
интро: интро 
ноготь: ногти 
прямо: прямо 
ранний: раньше 
лесбух: лесбуху 
поп: поп 
аборт: аборт 
аниме: аниме 
внимательный: повнимательней 
курить: курю 
забитый: забита 
мак: мак 
найти: нашёл найдёшь 
мутить: мучу 
купюра: купюр 
взять: взять 
ос: ос 
сказать: сказала 
ляпка: ляпки 
анхолдеть: анхолдит 
олень: оленем 
подружиться: подружились 
клей: клеем 
пять: пять 
её: её 
сойти: сойдём 
бля: бля 
ебать: ебать 
год: год 
новенький: новенькие 
неверленд: неверленд 
билли: билли 
врач: врачу 
мой: моих моём 
травка: травку 
биониклый: бионикл 
ваш: ваши 
рифма: рифму 
легально: легально 
слабо: слабо 
тот: те 
ум: ума 
ребёнок: дети 
кха: кха 
афродита: афродита 
