находиться: находился 
вокруг: вокруг 
данил: данила 
отменить: отменить отменили 
головной: головной 
чел: чел 
рейв: рейв 
понравиться: понравилось 
оказаться: оказался 
рэп: рэп 
искать: ищи искать 
выйти: выйдет вышел 
решить: решил решено 
разрешение: разрешение 
музыкант: музыканту 
принимать: принимает 
конфликт: конфликта 
свой: своим своих своём 
время: время времени 
закончить: закончена 
всё: всё 
русский: русский русских 
б: б 
салют: салют 
спать: спать 
доделаться: доделается 
март: марта 
россия: россией россия россии 
интересно: интересно 
февраль: февраля 
сильный: сильнее 
изначально: изначально 
проект: проект 
российский: российских 
будущее: будущем 
песня: песней песни песню 
сожаление: сожалению 
долго: долго 
лак: лаки 
узнать: узнали 
вирус: вируса вирусом вирус 
работа: работу 
идея: идея 
выход: выхода 
клэп: клэпом 
подставить: подставил 
договориться: договорится 
занятый: занят 
вне: вне 
положительный: положительным 
релиз: релиз релизы 
это: это 
готовый: готово 
придумать: придумал 
видеть: видел видите вижу 
украина: украины украиной 
прийти: пришла 
какой: какого каком 
число: числе 
дистрибьютор: дистрибьюторов 
сообщать: сообщает 
сведение: сведение 
пепел: пеплом 
офис: офис 
краткий: кратчайшие 
короче: короче 
который: который которых 
либо: либо 
сингл: синглом 
час: часов 
поздний: позже 
давно: давно 
проснуться: проснулся 
уверенный: уверен 
сказать: сказал сказать 
ставить: ставил 
начать: начал начать начали 
доделать: доделан доделать 
вечер: вечера 
приостановка: приостановке 
трек: трека трек треке 
дата: дату 
дописать: дописать допишу 
уровень: уровне 
даня: даня 
дть: демо 
нету: нету 
артист: артист артистам артистов 
покрыть: покрыть 
день: дня 
подумать: подумал 
утро: утра 
обещать: обещать 
совместный: совместной 
итого: итого 
взять: взял 
плакать: плакать 
авторский: авторская 
уходить: ухожу 
около: около 
быстрый: быстрее 
ответ: ответ 
группа: группой группы 
быть: буду будешь 
дан: дане 
вируситься: вируситься 
автор: автора 
знать: знаю знали 
срок: сроки 
сниппеть: сниппет сниппетом 
альбом: альбома 
горе: горю 
текст: текст 
рассказать: расскажу 
небо: небо 
сделать: сделать 
вообще: вообще 
понять: понял 
мощь: мощь 
музыкальный: музыкальные 
сомневаться: сомневаюсь 
бу: бу 
услышать: услышал 
кричать: кричал 
просто: просто 
ситуация: ситуацией 
оставить: оставить 
блядь: блять 
попробовать: попробую 
ждать: ждать 
ходить: хожу 
слушать: слушал 
площадка: площадках 
отправить: отправлен 
солистка: солистке 
почему: почему 
точно: точно 
этот: этих 
припев: припев 
музыка: музыку музыка 
объявить: объявил 
итог: итоге 
вдали: вдали 
дизайн: дизайн 
куплет: куплет 
ещё: ещё 
заставить: заставил 
мировой: мировые 
выпускать: выпускал выпускать 
что: чё 
трогать: трогаю 
выкладывать: выкладывал 
мощный: мощнейшая 
ремикс: ремикс 
хайперпоп: хайперпоп 
вроде: вроде 
утечка: утечке 
собираться: собирался 
поделиться: поделился 
интуитивный: интуитивном 
январь: января 
такой: таком 
доступный: доступен 
мельком: мельком 
нужно: нужно 
лейбл: лейблы лейбла 
выложить: выложил 
тикток: тиктоке 
написать: написать 
мнение: мнению 
мой: моему 
стиль: стиле 
решение: решение 
договариваться: договариваться 
ольга: ольга 
отменять: отменяет 
делать: делал 
ничего: ничё 
пока: пока 
ёбаный: ёбаная 
мочь: могу 
четверг: четверг 
поп: поп 
чужой: чужой 
ялрс: ялрс 
год: года 
тот: тому 
происходить: происходящей 
бочка: бочку 
хотя: хотя 
прекращать: прекращать 
использоваться: использовался 
выглядеть: выглядишь 
заявлять: заявляет 
вдыхать: вдыхай 
учитывать: учитывая 
деятельность: деятельности 
предложить: предложили 
пиздато: пиздато 
стадия: стадии 
получиться: получится 
фон: фоне 
слово: словам 
эхо: эхо 
многие: многие 
успеть: успели 
сэмпл: сэмпл 
повод: поводу 
пройти: прошли 
спрашивать: спрашивал 
страдать: страдать 
поработать: поработать 
уйти: уйду 
слушатель: слушатели 
