признаться: признаюсь 
оценить: оцени оценил 
из: изо 
слишком: слишком 
свой: своей своих 
всё: всё 
русский: русский 
б: б 
ты: тебе тобой 
держать: держи 
дать: дала дал 
спустя: спустя 
любовь: любовь любви 
голова: голова 
обещание: обещания 
амин: амина 
знать: знала знаю знал 
разбить: разбил 
подохнуть: подохнет 
месяц: месяца 
пустой: пустые 
решить: решила 
трек: трека 
октябрь: октября 
хороший: хороша 
чувство: чувств чувства 
ловить: ловлю 
аудитория: аудиторией 
поделиться: поделиться 
тот: той 
разгадать: разгадала 
быть: буду 
ил: ил 
аутро: аутро 
сниппеть: сниппет 
текст: текст 
исполнительница: исполнительница 
песня: песни 
мир: мир 
страница: странице 
первый: первый 
бридж: бридж 
просто: просто 
хватить: хватило хвати 
россия: россия 
припев: припев 
отдать: отдала 
я: мной 
версия: версией 
куплет: куплет 
ещё: ещё 
мамэтотолькодляфото: мамэтотолькодляфото 
сердце: сердце 
игрушка: игрушка 
забрать: заберёшь 
хайперпоп: хайперпоп 
врать: врать врёшь 
один: одну 
мочь: можешь 
крепко: крепко 
тикток: тиктоке 
держаться: держусь 
сила: сил 
злиться: злюсь 
воздух: воздух 
мой: моё мои мою 
интро: интро 
против: против 
поп: поп 
ключ: ключ 
ялрс: ялрс 
год: года 
подружка: подружку 
съесть: съел 
твой: твоя 
полный: полной 
похоть: похоть 
проглотить: проглотила 
представить: представила 
