поверь: поверь 
день: день дни 
тянка: тянку 
печаль: печали 
улететь: улечу 
солнце: солнце 
навсегда: навсегда 
бросать: бросаешь 
всё: всё 
русский: русский 
ты: тебе тобой 
твой: твои 
семья: семья 
любовь: любовь 
хотеть: хочу 
нужный: нужна 
прежде: прежде 
дискорд: дискорде 
один: одни 
дурак: дурак 
склеить: склеит 
сдаться: сдамся 
писать: пишем пишешь 
магнит: магниту 
зажечь: зажгли 
замёрзнуть: замёрзли 
тянуть: тянет 
забыть: забудем 
я: мною мной 
приехать: приехать 
другой: другую 
ответ: ответ 
знать: знаю знайте 
вновь: вновь 
текст: текст 
найти: найду нашёл 
песня: песни 
мир: мир 
спасти: спасёт 
грязь: грязь 
звонить: звонишь 
бридж: бридж 
чувство: чувства 
умереть: умерла 
давать: давали 
такой: такую такие 
интернет: интернете интернет 
убить: убьёт 
почему: почему 
чувствовать: чувствовать 
сразу: сразу 
погубить: погубит 
россия: россия 
мертворождённый: мертворождённой 
любить: люблю любить 
припев: припев 
огонь: огни 
несчастный: несчастным 
куплет: куплет 
ещё: ещё 
снова: снова 
приобрести: приобретённой 
говорить: говорить 
хайперпоп: хайперпоп 
быть: е 
мы: нами нам 
лицо: лицом 
который: которая 
лишь: лишь 
зая: зая 
друг: другу друг 
наивный: наивный 
пластырь: пластырь 
интро: интро 
мочь: могу 
поп: поп 
ыть: ыть 
каждый: каждый 
жалко: жалко 
убегать: убегают 
надежда: надежды 
забывать: забывая 
перестать: перестала 
захотеть: захотела 
понятно: понятно 
виноватый: виноват 
тот: те 
луна: луна 
