день: день 
человек: людей 
грубо: грубо 
твой: твоим 
любить: любят 
незадолго: незадолго 
всё: всё 
русский: русский русское 
ты: тебе тобой 
ответить: ответь 
больно: больно 
релиз: релиза 
ненавидеть: ненавидят 
мочь: мог можешь 
создать: создать 
м: м 
любовь: любовь 
хотеть: хочу хотела хочешь хотели 
колесо: колесо 
свой: свой 
отношение: отношениях отношения 
стандартный: стандартный 
это: это 
соврать: соврал 
фраза: фраза 
холодно: холодно 
жаль: жаль 
песня: песня песни песню 
скорость: скорость 
услышать: услышишь 
заново: заново 
диалог: диалог 
вместе: вместе 
чувствовать: чувствуешь 
егор: егор 
говорить: говори говорить говорим 
искать: искала 
история: историю 
пожаловать: пожаловать 
просить: просила 
спасатель: спасатель спасателя 
натс: натс 
летать: летать 
тонуть: тонущий тонущего 
парус: паруса 
крутиться: кручусь 
подбирать: подбираем 
тянуть: тянет 
предать: предав 
педаль: педаль 
взять: взял 
пахнуть: пахнет 
начинать: начинает 
перестать: перестал перестала 
февраль: февраль 
далёкий: дальше 
сильно: сильно 
потеряться: потерялась 
спасибо: спасибо 
быть: буду 
злиться: злиться 
находиться: находятся 
текст: текст 
столько: столько 
игра: игра 
спасать: спасает 
твиттер: твиттер 
просто: просто 
принять: приняла 
чувство: чувства 
жать: жмёшь 
постель: постель 
согласиться: согласилась 
конец: конца 
выше: выше 
прощать: прощаю 
ха: ха 
россия: россия 
почему: почему 
метель: метель 
душевный: душевный 
глава: глава 
припев: припев 
я: мной 
слово: слова словам 
куплет: куплет 
ещё: ещё 
пиздеть: пиздеть 
рука: руку 
знать: знай знаешь 
ахахи: ахахах 
слабак: слабак 
снова: снова 
сердце: сердце 
что: чё 
дать: данная дать 
устать: устал 
участие: участие 
поцеловать: поцеловал 
врать: врать 
бросить: бросил 
оставить: оставлю 
хайперпоп: хайперпоп 
такой: таких 
вес: вес 
интернет: интернет 
мы: нами 
выложить: выложил 
произойти: произошло 
весь: всем 
скидывать: скидываю 
замечательный: замечательная 
сила: силы 
синдром: синдром 
собрать: собрать 
равно: равно 
добро: добро 
два: двух 
интро: интро 
душнить: душнить 
понять: пойму 
холод: холод 
маленький: меньше 
поп: поп 
город: города 
каждый: каждый 
ялрс: ялрс 
верить: верить 
тот: тому 
целый: целую 
найти: нашел 
частый: чаще 
друг: друг друга 
аренби: аренби 
мой: мои моём 
правда: правды 
называть: называем 
её: её 
покорять: покорять 
абьюзивный: абьюзивные 
путь: путь 
сломать: сломали 
